为什么app朋友圈进不去，一点击动态就提示网络连接错误	app咨询
APP朋友圈怎么进不去	app咨询
APP朋友圈进不去	app咨询
APP朋友圈一直进不去	app咨询
app朋友圈怎么进不去	app咨询
app朋友圈进不去	app咨询
app朋友圈一直进不去	app咨询
怎么APP朋友圈进不去	app咨询
怎么我刚刚APP朋友圈进不去	app咨询
为什么APP朋友圈进不去	app咨询
查查我的APP朋友圈进不去	app咨询
怎么app朋友圈进不去	app咨询
怎么我刚刚app朋友圈进不去	app咨询
为什么app朋友圈进不去	app咨询
查查我的app朋友圈进不去	app咨询
app登陆不进去	app咨询
APP登陆不进去	app咨询
App登陆不进去	app咨询
aPP登陆不进去	app咨询
app登陆不过去	app咨询
app登陆不了	app咨询
app登陆问题	app咨询
申请LG下载红包	app咨询
LG下载app彩金在哪里申请	app咨询
LG下载彩金	app咨询
LG下载红包怎么申请	app咨询
LG红包要怎么申请	app咨询
LG红包优惠申请	app咨询
帮我申请LG下载彩金	app咨询
你们lg下载彩金怎样领取	app咨询
下在LG 申请红包	app咨询
下载LG申请红包	app咨询
下载LG申请红包优惠	app咨询
申请LG客户端	app咨询
申请LG红包	app咨询
领取LG下载礼金	app咨询
领取下载LG	app咨询
申请lg下载红包	app咨询
lg下载app彩金在哪里申请	app咨询
lg下载彩金	app咨询
lg下载红包怎么申请	app咨询
lg红包要怎么申请	app咨询
lg红包优惠申请	app咨询
帮我申请lg下载彩金	app咨询
你们lg下载彩金怎样领取	app咨询
下在lg 申请红包	app咨询
下载lg申请红包	app咨询
下载lg申请红包优惠	app咨询
申请lg客户端	app咨询
申请lg红包	app咨询
领取lg下载礼金	app咨询
领取下载lg	app咨询
申请Lg下载红包	app咨询
Lg下载app彩金在哪里申请	app咨询
Lg下载彩金	app咨询
Lg下载红包怎么申请	app咨询
Lg红包要怎么申请	app咨询
Lg红包优惠申请	app咨询
帮我申请Lg下载彩金	app咨询
你们Lg下载彩金怎样领取	app咨询
下在Lg 申请红包	app咨询
下载Lg申请红包	app咨询
下载Lg申请红包优惠	app咨询
申请Lg客户端	app咨询
申请Lg红包	app咨询
领取Lg下载礼金	app咨询
领取下载Lg	app咨询
申请lG下载红包	app咨询
lG下载app彩金在哪里申请	app咨询
lG下载彩金	app咨询
lG下载红包怎么申请	app咨询
lG红包要怎么申请	app咨询
lG红包优惠申请	app咨询
帮我申请lG下载彩金	app咨询
你们lG下载彩金怎样领取	app咨询
下在lG 申请红包	app咨询
下载lG申请红包	app咨询
下载lG申请红包优惠	app咨询
申请lG客户端	app咨询
申请lG红包	app咨询
领取lG下载礼金	app咨询
领取下载lG	app咨询
我投注流水已经够晋级了吗	VIP咨询
我流水够这个月晋级了吗？	VIP咨询
我要晋级的流水够了吗？	VIP咨询
晋级要多少流水才够啊	VIP咨询
VIP晋级需要多少流水才够啊	VIP咨询
帮我查下我这个月流水可以晋级了吗	VIP咨询
帮我查下晋级流水	VIP咨询
我要查一下晋级的流水	VIP咨询
要多少流水才可以晋级	VIP咨询
晋级多少流水够	VIP咨询
VIP晋级流水哪边看	VIP咨询
我投注的够晋级了吗	VIP咨询
我要投注多少才够晋级	VIP咨询
晋级需要多少投注	VIP咨询
我投注应该够了吧！可以晋级了吗	VIP咨询
我这月已经投注到晋级标准了，怎么晋级	VIP咨询
PT客户端不能登入	不能登录
PT客户端不能登	不能登录
PT客户端不能登陆	不能登录
PT客户端不能登录	不能登录
PT客户端登不进去	不能登录
PT客户端登不了	不能登录
PT客户端无法登入 	不能登录
DT客户端不能登入	不能登录
DT客户端不能登	不能登录
DT客户端不能登陆	不能登录
DT客户端不能登录	不能登录
DT客户端登不进去	不能登录
DT客户端登不了	不能登录
DT客户端无法登入 	不能登录
pt客户端不能登入	不能登录
pt客户端不能登	不能登录
pt客户端不能登陆	不能登录
pt客户端不能登录	不能登录
pt客户端登不进去	不能登录
pt客户端登不了	不能登录
pt客户端无法登入 	不能登录
dt客户端不能登入	不能登录
dt客户端不能登	不能登录
dt客户端不能登陆	不能登录
dt客户端不能登录	不能登录
dt客户端登不进去	不能登录
dt客户端登不了	不能登录
dt客户端无法登入 	不能登录
Pt客户端不能登入	不能登录
Pt客户端不能登	不能登录
Pt客户端不能登陆	不能登录
Pt客户端不能登录	不能登录
Pt客户端登不进去	不能登录
Pt客户端登不了	不能登录
Pt客户端无法登入 	不能登录
Dt客户端不能登入	不能登录
Dt客户端不能登	不能登录
Dt客户端不能登陆	不能登录
Dt客户端不能登录	不能登录
Dt客户端登不进去	不能登录
Dt客户端登不了	不能登录
Dt客户端无法登入 	不能登录
pT客户端不能登入	不能登录
pT客户端不能登	不能登录
pT客户端不能登陆	不能登录
pT客户端不能登录	不能登录
pT客户端登不进去	不能登录
pT客户端登不了	不能登录
pT客户端无法登入 	不能登录
dT客户端不能登入	不能登录
dT客户端不能登	不能登录
dT客户端不能登陆	不能登录
dT客户端不能登录	不能登录
dT客户端登不进去	不能登录
dT客户端登不了	不能登录
dT客户端无法登入 	不能登录
PT怎么登陆帐号密码错误	不能登录
DT怎么登陆帐号密码错误	不能登录
PT怎么登陆账号密码错误	不能登录
DT怎么登陆账号密码错误	不能登录
PT怎么登陆显示帐号密码错误	不能登录
DT怎么登陆显示帐号密码错误	不能登录
PT怎么登陆显示账号密码错误	不能登录
DT怎么登陆显示账号密码错误	不能登录
PT怎么登陆说帐号密码错误	不能登录
DT怎么登陆说帐号密码错误	不能登录
PT怎么登陆说账号密码错误	不能登录
DT怎么登陆说账号密码错误	不能登录
怎么登陆PT说账号密码错误	不能登录
怎么登陆DT说账号密码错误	不能登录
合并过来的会员账号前加什么字母？	不能登录
合并后的账号前要加什么	不能登录
合并了，我的账号前要加什么才能进入	不能登录
你们合并，我要怎么登陆以前的账号	不能登录
合并后要如何登陆账号	不能登录
合并的账号前要加什么字母	不能登录
什么是防劫持安装包	不能登录
找不到防劫持安装包	不能登录
哪里找防劫持安装包	不能登录
安装防劫持安装包	不能登录
防劫持安装包 在哪?找不到啊	不能登录
防劫持安装包是什么	不能登录
我要防劫持安装包	不能登录
求给几个稳定线路	不能登录
先把线路检测给我	不能登录
我换了好几个线路都没进去	不能登录
有没有其他检测的线路	不能登录
有其他线路吗?	不能登录
网站要跳转，给我发个快速线路的网址	不能登录
检测的线路是多少?	不能登录
线路检测	不能登录
给我个线路	不能登录
请问线路检测	不能登录
请问线路检测是多少？	不能登录
被劫持了，台式电脑DNS和手机的DNS是一样的吗	不能登录
被劫持了，什么DNS的	不能登录
怎么改DNS？我被劫持了	不能登录
你们官网被劫持了，叫我改DNS	不能登录
DNS是什么，我进不去官网了	不能登录
太阳城是什么，你们DNS被劫持了吗	不能登录
DNS怎么改	不能登录
DNS怎么修改，我进去官网是太阳城	不能登录
你们被太阳城劫持了吗？怎么修改DNS	不能登录
教我修改DNS，被劫持了	不能登录
你们官网被绑架了，怎么改DNS	不能登录
你们在线客服被狭持了，我要改DNS吗？	不能登录
电脑怎么改DNS	不能登录
手机怎么改DNS	不能登录
什么是DNS	不能登录
你们被劫持了吗？还要我改DNS	不能登录
怎么我这里地区限制是什么意思	不能登录
地区限制是什么	不能登录
为什么我登入说地区限制	不能登录
地区限制是不给玩吗	不能登录
怎么说我地区限制	不能登录
怎么登录说我地区限制	不能登录
怎么这里有地区限制是什么意思	不能登录
地区限制是怎么回事	不能登录
为什么我登陆说地区限制	不能登录
地区限制是不给我玩吗	不能登录
怎么会说我地区限制	不能登录
怎么登入说我地区限制	不能登录
为何显示该地区不支持访问	不能登录
区域不支持访问什么意思	不能登录
地区不支持访问怎么突然就这样	不能登录
你所在的地区暂不支持访问	不能登录
为什么我IP不支持访问？	不能登录
为何显示该地区不支持访问演出	不能登录
怎么显示该地区不支持访问	不能登录
他提示你所在的地区暂不支持访问	不能登录
出现地区不支持访问怎么搞	不能登录
网页提示区域不支持访问什么意思	不能登录
地区不支持访问怎么办	不能登录
怎么提示我示该地区不支持	不能登录
我怎么出现区域不支持访问?	不能登录
出现地区不支持访问该怎么办	不能登录
什么情况	查询账号状态
催一下	查询账号状态
解决好了么	查询账号状态
还没好吗	查询账号状态
快点啊	查询账号状态
查到了嗎?	查询账号状态
查了吗	查询账号状态
查了吗?	查询账号状态
查到了吗	查询账号状态
查了没	查询账号状态
查到了没	查询账号状态
还没好啊	查询账号状态
快好了没	查询账号状态
快好了吗	查询账号状态
什么状况	查询账号状态
什么情况啊	查询账号状态
什么状况啊	查询账号状态
解决了吧	查询账号状态
解决了吗	查询账号状态
解决了吗?	查询账号状态
快一点	查询账号状态
可以快一点吗	查询账号状态
帮我查一下	查询账号状态
看一下进度	查询账号状态
麻烦快点	查询账号状态
可以请你们快一点吗	查询账号状态
可以快一点吗	查询账号状态
还是没好吗	查询账号状态
快点	查询账号状态
不能快点吗	查询账号状态
还没查到吗	查询账号状态
快查到了吗	查询账号状态
还没看到吗	查询账号状态
还没解决吗	查询账号状态
没有办法查到吗	查询账号状态
查不到吗	查询账号状态
怎么回事	查询账号状态
发生什么事	查询账号状态
到底是怎么了	查询账号状态
没有人可以查吗	查询账号状态
没有人可以看进度吗	查询账号状态
有人可以查吗	查询账号状态
有人可以看进度吗	查询账号状态
哪里查进度	查询账号状态
哪里查现在状况	查询账号状态
哪里可以看现在是什么情况	查询账号状态
哪里可以查现在是怎么了	查询账号状态
现在到底怎么了	查询账号状态
现在是什么情况	查询账号状态
什么时候发呢	查询账号状态
什么时候查好	查询账号状态
什么时候查到	查询账号状态
我总共存款多少了，帮我查询下	查询账号状态
查询一下我的存款总共多少	查询账号状态
我累积的存款目前多少，帮我查询看看	查询账号状态
你查询一下，我的总存款目前多少	查询账号状态
你查询看看我的存款目前累积多少了	查询账号状态
帮我查询目前总共存款多少	查询账号状态
好了没	查询账号状态
还没有处理好吗?	查询账号状态
好了没有	查询账号状态
好了没有嘛	查询账号状态
解决好了没有啊	查询账号状态
查好了没	查询账号状态
查好了没有	查询账号状态
处理好了没有	查询账号状态
处理好了吗	查询账号状态
现在好了没	查询账号状态
都搞好了没有	查询账号状态
解决好没	查询账号状态
处理好没	查询账号状态
怎么回事	查询账号状态
还要多久	查询账号状态
解决好了没有	查询账号状态
解决了吗?	查询账号状态
你帮我处理好没	查询账号状态
处理到什么时候	查询账号状态
还要处理多久	查询账号状态
你处理快点，还要多久	查询账号状态
快点处理，好了没	查询账号状态
速度一点啊	查询账号状态
速度速度快点	查询账号状态
动作能不能快一点	查询账号状态
快点行麻	查询账号状态
查不到吗?	查询账号状态
查多久了	查询账号状态
查那么久还没查到	查询账号状态
到底查到了吗	查询账号状态
到底怎么回事	查询账号状态
到底是怎么回事	查询账号状态
怎么回事哦	查询账号状态
怎么回事儿啊	查询账号状态
你们怎么回事	查询账号状态
怎么回事啊	查询账号状态
你们台怎么回事	查询账号状态
你们有些怎么回事	查询账号状态
你们这边怎么回事	查询账号状态
是怎么回事	查询账号状态
你们是怎么回事？	查询账号状态
你好没有啊	查询账号状态
弄好没	查询账号状态
弄好没有	查询账号状态
你弄快点啊	查询账号状态
到底弄好了没有啊	查询账号状态
要搞多久啊	查询账号状态
搞好没有	查询账号状态
搞完了吗	查询账号状态
搞好了吗?	查询账号状态
搞定了没	查询账号状态
还需要搞多久	查询账号状态
叫你搞个东西需要这么久吗	查询账号状态
找不找的到啊	查询账号状态
找到的了吗	查询账号状态
到底找到了没有	查询账号状态
要找到什么时候	查询账号状态
还要找多久	查询账号状态
找好久噢，还要多久	查询账号状态
找这么久还不到吗	查询账号状态
还要找多久时间啊	查询账号状态
怎么个情况	查询账号状态
如何注册游戏账号	官网及账号问题
怎么注册游戏账号	官网及账号问题
为什么不能注册游戏账号	官网及账号问题
不可以注册游戏账号吗	官网及账号问题
怎么不行注册游戏账号	官网及账号问题
无法注册游戏账号	官网及账号问题
怎么无法注册游戏账号	官网及账号问题
如何注册游戏帐号	官网及账号问题
怎么注册游戏帐号	官网及账号问题
为什么不能注册游戏帐号	官网及账号问题
不可以注册游戏帐号吗	官网及账号问题
怎么不行注册游戏帐号	官网及账号问题
无法注册游戏帐号	官网及账号问题
怎么无法注册游戏帐号	官网及账号问题
电脑怎么截屏	官网及账号问题
电脑如何截屏	官网及账号问题
我要怎么截屏	官网及账号问题
请问截屏功能在哪	官网及账号问题
我不会截屏	官网及账号问题
截屏要怎么用	官网及账号问题
要怎么用截屏	官网及账号问题
打电话给我	官网及账号问题
打电话给我啊	官网及账号问题
打电话给我吧	官网及账号问题
我说叫你们客服打电话给我	官网及账号问题
打给我	官网及账号问题
打过来	官网及账号问题
请用打电话给我	官网及账号问题
来个活人好不好	官网及账号问题
有活人没？	官网及账号问题
有活人吗	官网及账号问题
活人出来	官网及账号问题
让真人客服来	官网及账号问题
是不是真人	官网及账号问题
真人不在吗	官网及账号问题
有活人在吗?	官网及账号问题
找真人	官网及账号问题
找活人来	官网及账号问题
请活人来来讲话	官网及账号问题
有活人线上吗?	官网及账号问题
没有真人客服？	官网及账号问题
没有活人客服?	官网及账号问题
来个真人	官网及账号问题
有真人没	官网及账号问题
可以问真人吗	官网及账号问题
换真人客服	官网及账号问题
是不是真人客服	官网及账号问题
工作人员哪去了	官网及账号问题
工作人员去哪了	官网及账号问题
那边有工作人员	官网及账号问题
我要找工作人员	官网及账号问题
工作人员呢	官网及账号问题
给我找工作人员来	官网及账号问题
快点给我找来工作人员	官网及账号问题
不要你，给我找来工作人员	官网及账号问题
给我叫工作人员过来	官网及账号问题
你给我找找工作人员	官网及账号问题
找你们的工作人员	官网及账号问题
去哪找工作人员	官网及账号问题
那边可以找工作人员	官网及账号问题
叫工作人员出来跟我讲话	官网及账号问题
工作人员哪去了呢	官网及账号问题
叫你们的工作人员出来	官网及账号问题
怎么还没有给我致电	官网及账号问题
什么时候给我致电呢	官网及账号问题
为什么要致电呢	官网及账号问题
给我致电	官网及账号问题
多久致电呢	官网及账号问题
怎么还没有给我致电	官网及账号问题
致电过来，不用花多少时间	官网及账号问题
致电可以打过来吧	官网及账号问题
你现在致电给我吧	官网及账号问题
你等等再致电给我吧	官网及账号问题
到底什么时候会致电给我	官网及账号问题
快点给我致电	官网及账号问题
给我打电话	官网及账号问题
怎么还没有给我电话	官网及账号问题
什么时候给我电话呢	官网及账号问题
为什么要电话呢	官网及账号问题
给我电话	官网及账号问题
多久电话呢	官网及账号问题
怎么还没有给我电话	官网及账号问题
电话过来，不用花多少时间	官网及账号问题
电话可以打过来吧	官网及账号问题
你现在电话给我吧	官网及账号问题
你等等再电话给我吧	官网及账号问题
到底什么时候会电话给我	官网及账号问题
快点给我电话	官网及账号问题
咨询电话多少	官网及账号问题
怎么发图片	官网及账号问题
不会发图片	官网及账号问题
怎么发图片给你	官网及账号问题
图片要如何给你	官网及账号问题
怎么截取图片	官网及账号问题
图片怎么发	官网及账号问题
请问图片怎么发	官网及账号问题
发图片给你	官网及账号问题
怎么发图片到电脑上	官网及账号问题
换了这个版本不知道怎么发送图片呀	官网及账号问题
我发图片给你看你看不到啊？	官网及账号问题
图片发不了	官网及账号问题
您好收到图片了吗	官网及账号问题
救济金怎么还没到账	救援金咨询
怎么救济金到帐没有	救援金咨询
我的救济金有到帐了吗	救援金咨询
我的救济金还没到账啊	救援金咨询
帮我看看救济金到账没	救援金咨询
你们有救济金吗	救援金咨询
救济金一直没到帐	救援金咨询
怎么昨天的救济金没到帐	救援金咨询
我的救济金怎么都没到帐	救援金咨询
怎么我的救援还没到	救援金咨询
救援怎么还没到	救援金咨询
我的救援呢	救援金咨询
看看救援派了没有	救援金咨询
救援派发了吗	救援金咨询
救援要怎么领取	救援金咨询
今天没有救援吗	救援金咨询
救援要怎么申请	救援金咨询
为什么我没有救援	救援金咨询
现在有没有救援可以领取	救援金咨询
派发救援了吗	救援金咨询
刚刚我设置密宝的时候忘记设置什么了。怎么办呢	密保银行卡解绑
我忘记密宝是什么了	密保银行卡解绑
帮我看下我的密宝	密保银行卡解绑
密宝忘记了怎么办	密保银行卡解绑
密宝要怎么找回	密保银行卡解绑
我忘记密宝，你能帮我查查吗	密保银行卡解绑
为什么不能提钱呀！	提款相关问题
怎么不能提钱	提款相关问题
提钱怎么没到	提款相关问题
看一下我提的钱怎么没到	提款相关问题
我提的钱在哪	提款相关问题
提的钱还没好吗	提款相关问题
我可以提钱了吗	提款相关问题
为什么无法提钱	提款相关问题
提钱要多久才到	提款相关问题
我刚提的钱帮我查一下	提款相关问题
提钱要多久才到	提款相关问题
ttg什么时候维修完	系统维护状况说明
ttg什么时候维修完成?	系统维护状况说明
ttg什么时候维修完?	系统维护状况说明
ttg维修到什麽时候?	系统维护状况说明
TTG什么时候维修完	系统维护状况说明
TTg什么时候维修完	系统维护状况说明
ttG什么时候维修完	系统维护状况说明
我BBIN玩糖果派对2时突然掉线，现在上去，原有的700多元不见了	游戏进不去
糖果派对怎么不能玩	游戏进不去
糖果派对掉线了	游戏进不去
糖果派对突然掉线，上不去	游戏进不去
糖果派对上不去了	游戏进不去
糖果派对怎么玩不了	游戏进不去
糖果派对进不去啊	游戏进不去
糖果派对无法进去啊	游戏进不去
糖果派对有问题吗	游戏进不去
糖果派对现在怎么不可以玩	游戏进不去
怎么糖果派对进不去	游戏进不去
怎么糖果派对不能玩	游戏进不去
怎么糖果派对突然掉线	游戏进不去
怎么糖果派对上不去	游戏进不去
dt平台有问题了吗	游戏进不去
PT平台有问题了吗	游戏进不去
AG平台有问题了吗	游戏进不去
MG平台有问题了吗	游戏进不去
QT平台有问题了吗	游戏进不去
NT平台有问题了吗	游戏进不去
TGG平台有问题了吗	游戏进不去
DT平台有问题了吗	游戏进不去
BBIN平台有问题了吗	游戏进不去
dt有问题了吗	游戏进不去
PT有问题了吗	游戏进不去
AG有问题了吗	游戏进不去
MG有问题了吗	游戏进不去
QT有问题了吗	游戏进不去
NT有问题了吗	游戏进不去
TGG有问题了吗	游戏进不去
DT有问题了吗	游戏进不去
BBIN有问题了吗	游戏进不去
我登录PT客户端提示我有未完成游戏可我不知道是那个游戏啊	游戏进不去
我登录PT客户端提示我有未完成游戏可我不知道是那个游戏?	游戏进不去
我登录PT客户端提示我有未完成游戏可我不知道是那个游戏啊?	游戏进不去
我登录PT客户端提示我有未完成游戏可我不知道是那个游戏呀?	游戏进不去
我登录PT客户端提示我有未完成游戏可我不知道是那个?	游戏进不去
我登录PT客户端提示我有未完成游戏，什麽意思?	游戏进不去
我登录PT客户端提示我有未完成游戏，怎麽办?	游戏进不去
ag出现什么样的问题	游戏进不去
ag出现什么问题	游戏进不去
ag是什么况状	游戏进不去
ag是什么问题	游戏进不去
ag是有什么问题?	游戏进不去
ag有什么问题	游戏进不去
ag发生什么问题	游戏进不去
ag现在出现什么情况	游戏进不去
ag现在是什么情况	游戏进不去
AG现在是什么问题	游戏进不去
ag现在有什么样的状况	游戏进不去
我卡三倍猴子里了	游戏进不去
我卡古怪猴子里了	游戏进不去
我卡船长的宝藏里了	游戏进不去
我游戏卡了	游戏进不去
我ttg游戏卡了	游戏进不去
我pt游戏卡了	游戏进不去
我卡疯狂七了	游戏进不去
我翡翠公主卡在里面了	游戏进不去
我卡游戏里面了	游戏进不去
我游戏卡在里面了	游戏进不去
我卡死在游戏里面了	游戏进不去
印加帝国是哪个平台？	游戏咨询
年年有余是哪个平台？	游戏咨询
摇滚之夜是哪个平台？	游戏咨询
印加帝国是哪个平台？	游戏咨询
赛亚烈战是哪个平台？	游戏咨询
大蓝是哪个平台？	游戏咨询
招财进宝是哪个平台？	游戏咨询
糖果派对是哪个平台？	游戏咨询
三倍猴子是哪个平台？	游戏咨询
妹妹很饿是哪个平台？	游戏咨询
英雄之战是哪个平台？	游戏咨询
真人游戏有哪些平台呢	游戏咨询
体育游戏有哪些平台	游戏咨询
棋牌游戏有哪些平台	游戏咨询
彩票游戏有哪些平台	游戏咨询
捕鱼游戏有哪些平台	游戏咨询
老虎机有哪些平台	游戏咨询
真人娱乐有哪些平台	游戏咨询
捕鱼有哪些平台	游戏咨询
百家乐有哪些平台	游戏咨询
体育有哪些平台	游戏咨询
彩票有哪些平台	游戏咨询
真人游戏有什么平台呢	游戏咨询
体育游戏有什么平台	游戏咨询
棋牌游戏有什么平台	游戏咨询
彩票游戏有什么平台	游戏咨询
捕鱼游戏有什么平台	游戏咨询
老虎机有什么平台	游戏咨询
真人娱乐有什么平台	游戏咨询
捕鱼有什么平台	游戏咨询
百家乐有什么平台	游戏咨询
体育有什么平台	游戏咨询
彩票有什么平台	游戏咨询
要怎么玩申博真人	游戏咨询
申博要怎麼玩	游戏咨询
申博真人好玩吗	游戏咨询
申博真人怎么玩啊	游戏咨询
申博是什么	游戏咨询
申博好玩吗	游戏咨询
申博真人怎么游戏	游戏咨询
申博真人如何游戏	游戏咨询
我想玩申博真人	游戏咨询
申博有什么好玩	游戏咨询
我想玩申博	游戏咨询
申博真人有什么好玩	游戏咨询
申博真人是什么	游戏咨询
申博怎么游戏	游戏咨询
申博如何游戏	游戏咨询
要怎么玩申博	游戏咨询
申博真人怎么玩	游戏咨询
百家乐怎么玩	游戏咨询
捕鱼怎么玩	游戏咨询
老虎机怎么玩	游戏咨询
AG真人怎么玩	游戏咨询
真人娱乐怎么玩	游戏咨询
棋牌怎么玩	游戏咨询
体育怎么玩	游戏咨询
彩票怎么玩	游戏咨询
申博真人如何玩	游戏咨询
百家乐如何玩	游戏咨询
捕鱼如何玩	游戏咨询
老虎机如何玩	游戏咨询
AG真人如何玩	游戏咨询
真人娱乐如何玩	游戏咨询
棋牌如何玩	游戏咨询
体育如何玩	游戏咨询
彩票如何玩	游戏咨询
年年有余怎么玩	游戏咨询
大蓝怎么玩	游戏咨询
印加帝国怎么玩	游戏咨询
妹妹很饿如何玩	游戏咨询
三倍猴子如何玩	游戏咨询
糖果派对如何玩	游戏咨询
没有BBIN吗？	游戏咨询
怎么没有BBIN	游戏咨询
找不到BBIN	游戏咨询
BBIN在哪	游戏咨询
BBIN怎么找不到	游戏咨询
现在没有BBIN了吗	游戏咨询
怎么没看到BBIN	游戏咨询
在哪玩BBIN	游戏咨询
推荐平台、有啥推荐的平台吗	游戏咨询
你们有推荐的平台吗	游戏咨询
有什么推荐的平台	游戏咨询
帮我推荐一下平台	游戏咨询
给我推荐一下平台	游戏咨询
推荐有没有什么不错的平台	游戏咨询
可以推荐有好的平台吗	游戏咨询
好的平台推荐一下	游戏咨询
推荐一下好的平台	游戏咨询
有啥推荐的平台吗	游戏咨询
有什么推荐的平台吗	游戏咨询
比赛一般结束多久结算	游戏咨询
我要结算我的注单	游戏咨询
比赛的注单结帐一下	游戏咨询
比赛结束什么时候结算	游戏咨询
体育注单结算了没	游戏咨询
体育注单结账了没	游戏咨询
怎么结算体育注单	游戏咨询
比赛注单结算了没	游戏咨询
比赛注单结账了没	游戏咨询
怎么结算比赛注单	游戏咨询
体育的注单结帐一下	游戏咨询
体育结束什么时候结算	游戏咨询
体育一般结束多久结算	游戏咨询
我要结算我的体育注单	游戏咨询
我要结算我的比赛注单	游戏咨询
只能下一万注码吗	游戏咨询
为什么说限红	游戏咨询
限红是什么	游戏咨询
怎么会有限红啊	游戏咨询
限红是什么意思	游戏咨询
什么是限红	游戏咨询
怎么说限红	游戏咨询
只能下多少注码?	游戏咨询
去哪查限红	游戏咨询
注码有限制只能下多少吗	游戏咨询
限红是限制什么	游戏咨询
注码只能下一万吗	游戏咨询
财神888这款游戏咱们平台有吗	游戏咨询
印加帝国这款游戏咱们平台有吗	游戏咨询
年年有余这款游戏咱们平台有吗	游戏咨询
摇滚之夜这款游戏咱们平台有吗	游戏咨询
印加帝国这款游戏咱们平台有吗	游戏咨询
赛亚烈战这款游戏咱们平台有吗	游戏咨询
大蓝这款游戏咱们平台有吗	游戏咨询
招财进宝这款游戏咱们平台有吗	游戏咨询
糖果派对这款游戏咱们平台有吗	游戏咨询
三倍猴子这款游戏咱们平台有吗	游戏咨询
妹妹很饿这款游戏咱们平台有吗	游戏咨询
英雄之战这款游戏咱们平台有吗	游戏咨询
怎么在泛亚电竞下注	游戏咨询
我要如何在泛亚电竞下注	游戏咨询
泛亚电竞要怎么下注	游戏咨询
泛亚电竞要怎么玩	游戏咨询
泛亚电竞要怎么进行泛亚电竞	游戏咨询
泛亚电竞要如何下注	游戏咨询
游戏倍率出错	游戏咨询
游戏赔率怎么看	游戏咨询
游戏赔率要如何查看	游戏咨询
要怎么查看游戏赔率	游戏咨询
游戏赔率好像有误	游戏咨询
游戏赔率不正确	游戏咨询
游戏倍率是不是有问题	游戏咨询
我的游戏赔率错了	游戏咨询
游戏赔率好像不对	游戏咨询
赔付有问题吧?	游戏咨询
看一下我的游戏赔付	游戏咨询
我的赔付好像少钱了	游戏咨询
老子有的是钱，想打游戏	游戏咨询
老子有的是钱，但不知道怎么游戏	游戏咨询
老子有的是钱，要怎么开始游戏	游戏咨询
老子有的是钱，要怎么进行游戏	游戏咨询
老子有的是钱，什么游戏好打	游戏咨询
老子有的是钱，推荐一下好打游戏	游戏咨询
pt里哪个好打点	游戏咨询
PT里哪个好打点	游戏咨询
Pt里哪个好打点	游戏咨询
pT里哪个好打点	游戏咨询
pt里哪个好打一点?	游戏咨询
pt里哪个好打?	游戏咨询
pt里哪个好打呢?	游戏咨询
你们ag电子游戏是什么平台?自助存送.我选什么平台	游戏咨询
你们ag电子游戏是什么平台呀?	游戏咨询
你们ag电子游戏在哪里?	游戏咨询
你们ag电子游戏怎麽玩?	游戏咨询
你们ag电子游戏在哪里? 怎麽选平台?	游戏咨询
你们ag电子游戏在哪里? 要去哪个平台玩?	游戏咨询
你们ag电子游戏在哪里? 要去哪个平台?	游戏咨询
老虎机平台有哪些	游戏咨询
老虎机有哪几个平台能游戏	游戏咨询
老虎机账户可以打哪些游戏平台	游戏咨询
老虎机钱包能玩那几个平台？	游戏咨询
老虎机钱包可以玩什么平台游戏啊	游戏咨询
老虎机钱包游戏是那种游戏平台	游戏咨询
狂野的遗产是什么平台	游戏咨询
梦幻邂逅是哪个平台？	游戏咨询
宇宙晶体是哪个平台？	游戏咨询
圣诞企鹅是哪个平台？	游戏咨询
白鲸记是哪个平台？	游戏咨询
快乐甜品是哪个平台？	游戏咨询
五行封神榜是哪个平台？	游戏咨询
猴宝宝2是哪个平台？	游戏咨询
水果派对是哪个平台？	游戏咨询
怎么五点多的赛事，到现在还不结算	游戏咨询
怎么刚刚踢球，都已经结束了，没结算	游戏咨询
你们体育怎么游戏	游戏咨询
赛事的盘口怎么不一样	游戏咨询
怎么取修比赛了	游戏咨询
滚球怎么结算	游戏咨询
体育赛事有怎么进行	游戏咨询
危险球投注怎么没有算	游戏咨询
我注单怎么没有结算	游戏咨询
我的註单怎么还没结算	游戏咨询
刚刚的赛事结算了吗	游戏咨询
赛事有延迟结算吗	游戏咨询
赛事还没结算吗	游戏咨询
账号解冻	账号解锁、忘记账号
自助解冻账号	账号解锁、忘记账号
解冻账号	账号解锁、忘记账号
账户解冻	账号解锁、忘记账号
麻烦你帮这个帐号c138883解冻可以吗	账号解锁、忘记账号
我的账号冻结了帮我解冻	账号解锁、忘记账号
自助解冻帐号	账号解锁、忘记账号
帮忙解冻一下账号	账号解锁、忘记账号
账号cfl521解冻	账号解锁、忘记账号
麻烦你帮我解冻	账号解锁、忘记账号
hc1974解冻账号	账号解锁、忘记账号
解冻账号，jiang0627	账号解锁、忘记账号
亲请帮我把账号解冻一下	账号解锁、忘记账号
麻烦帮忙解冻	账号解锁、忘记账号
显示账号不能解冻	账号解锁、忘记账号
双十一回归怎么领	咨询当下相关活动
双十一回归是什么	咨询当下相关活动
双十一回归什么时候领	咨询当下相关活动
双十一回归什么时候派发	咨询当下相关活动
什么时候派发双十一回归	咨询当下相关活动
双十一回归开始了吗	咨询当下相关活动
双十一回归怎么领	咨询当下相关活动
双十一回归怎么不能领	咨询当下相关活动
怎么领双十一回归	咨询当下相关活动
什么时候领双十一回归	咨询当下相关活动
怎么不能领双十一回归	咨询当下相关活动
不能领双十一回归吗	咨询当下相关活动
为什么找不到双十一回归	咨询当下相关活动
双十一回归开始了吧	咨询当下相关活动
双十一回归不派发吗	咨询当下相关活动
怎么没有办法领双十一回归	咨询当下相关活动
我想领双十一回归	咨询当下相关活动
发信息说送25把免费游戏	咨询当下相关活动
发信息不是说送彩金	咨询当下相关活动
发信息不是说有免费游戏	咨询当下相关活动
发信息不是说送免费转	咨询当下相关活动
发信息不是会送钱	咨询当下相关活动
发信息不是会给免费游戏	咨询当下相关活动
发信息不是会给彩金	咨询当下相关活动
发信息不是会送彩金	咨询当下相关活动
发信息不是会送免费游戏	咨询当下相关活动
发信息不是会送免费转	咨询当下相关活动
输钱全返報名	咨询当下相关活动
输钱全反报名	咨询当下相关活动
输钱全返怎么申请	咨询当下相关活动
输钱全反怎么申请	咨询当下相关活动
输钱全返彩金多少	咨询当下相关活动
输钱全反彩金多少	咨询当下相关活动
输钱全返彩金发了吗	咨询当下相关活动
输钱全反彩金发了吗	咨询当下相关活动
输钱全返不能申请吗	咨询当下相关活动
输钱全反不能申请吗	咨询当下相关活动
输钱全返申请方式	咨询当下相关活动
输钱全反申请方式	咨询当下相关活动
输钱全返怎么领	咨询当下相关活动
输钱全反怎么领	咨询当下相关活动
U乐卡当天派发吗	咨询当下相关活动
U乐卡什么时候派发	咨询当下相关活动
U乐卡怎么办	咨询当下相关活动
怎么办U乐卡	咨询当下相关活动
什么时候派发U乐卡	咨询当下相关活动
当天派发U乐卡吗	咨询当下相关活动
怎么领U乐卡	咨询当下相关活动
U乐卡怎么领	咨询当下相关活动
U乐卡可以马上领吗	咨询当下相关活动
U乐卡现在可以领了吗	咨询当下相关活动
现在可以领U乐卡了吗	咨询当下相关活动
U乐卡现在可以用了吗	咨询当下相关活动
U乐卡可以做啥	咨询当下相关活动
U乐卡是什么	咨询当下相关活动
什么是U乐卡	咨询当下相关活动
怎么可以领U乐卡	咨询当下相关活动
这个月有啥特别的好处	咨询当下相关活动
这个月有啥特别的好康	咨询当下相关活动
这个月有啥特别的好东西	咨询当下相关活动
这个月有啥特别的好处?	咨询当下相关活动
这个月有啥特别的好康?	咨询当下相关活动
这个月有啥特别的?	咨询当下相关活动
这个月有啥特别的好活动?	咨询当下相关活动
动态里发布旅游照片了，可以领取彩金了吧，怎么领取	咨询当下相关活动
动态里发布旅游照片了，可以领取彩金了吧，怎么领取?	咨询当下相关活动
动态里发布旅游照片了，可以领取彩金了吧?	咨询当下相关活动
动态里发布旅游照片了，可以领取彩金了吧，该怎么领取?	咨询当下相关活动
动态里发布旅游照片了，可以领取彩金了吧，可以怎么领?	咨询当下相关活动
动态里发布旅游照片了，可以领取彩金了吗?	咨询当下相关活动
返赠卡怎么领取	咨询当下相关活动
返赠卡，怎么使用？	咨询当下相关活动
请问返赠卡要怎么激活	咨询当下相关活动
返赠卡是怎么领取的	咨询当下相关活动
我的返赠卡无法使用，为什么？	咨询当下相关活动
返赠卡怎么领取呢?	咨询当下相关活动
请问一下你们那个返赠卡是怎么领的	咨询当下相关活动
返赠卡是什么？	咨询当下相关活动
领取会员返赠卡	咨询当下相关活动
返赠卡是什么	咨询当下相关活动
我能领返赠卡吗	咨询当下相关活动
如何领取返赠卡	咨询当下相关活动
你好！在哪里领取返赠卡？谢谢！	咨询当下相关活动
返赠卡怎么弄的	咨询当下相关活动
怎么使用返赠卡	咨询当下相关活动
返赠卡是啥呢	咨询当下相关活动
返赠卡是啥玩意	咨询当下相关活动
返赠卡怎么激活	咨询当下相关活动
给我一张返赠卡	咨询当下相关活动
返赠卡怎么使用	咨询当下相关活动
返赠卡是怎么用	咨询当下相关活动
返赠卡怎么申请	咨询当下相关活动
返赠卡什么意思？	咨询当下相关活动
返赠卡完全不能领是什么情况	咨询当下相关活动
返赠卡根本领不了，假的？	咨询当下相关活动
返赠卡啥东西哦	咨询当下相关活动
什么是返赠卡	咨询当下相关活动
返增卡怎么领取	咨询当下相关活动
返增卡，怎么使用？	咨询当下相关活动
请问返增卡要怎么激活	咨询当下相关活动
返增卡是怎么领取的	咨询当下相关活动
我的返增卡无法使用，为什么？	咨询当下相关活动
返增卡怎么领取呢?	咨询当下相关活动
请问一下你们那个返增卡是怎么领的	咨询当下相关活动
返增卡是什么？	咨询当下相关活动
领取会员返增卡	咨询当下相关活动
返增卡是什么	咨询当下相关活动
我能领返增卡吗	咨询当下相关活动
如何领取返增卡	咨询当下相关活动
你好！在哪里领取返增卡？谢谢！	咨询当下相关活动
返增卡怎么弄的	咨询当下相关活动
怎么使用返增卡	咨询当下相关活动
返增卡是啥呢	咨询当下相关活动
返增卡是啥玩意	咨询当下相关活动
返增卡怎么激活	咨询当下相关活动
给我一张返增卡	咨询当下相关活动
返增卡怎么使用	咨询当下相关活动
返增卡是怎么用	咨询当下相关活动
返增卡怎么申请	咨询当下相关活动
返增卡什么意思？	咨询当下相关活动
返增卡完全不能领是什么情况	咨询当下相关活动
返增卡根本领不了，假的？	咨询当下相关活动
返增卡啥东西哦	咨询当下相关活动
什么是返增卡	咨询当下相关活动
反正卡怎么领取	咨询当下相关活动
反正卡，怎么使用？	咨询当下相关活动
请问反正卡要怎么激活	咨询当下相关活动
反正卡是怎么领取的	咨询当下相关活动
我的反正卡无法使用，为什么？	咨询当下相关活动
反正卡怎么领取呢?	咨询当下相关活动
请问一下你们那个反正卡是怎么领的	咨询当下相关活动
反正卡是什么？	咨询当下相关活动
领取会员反正卡	咨询当下相关活动
反正卡是什么	咨询当下相关活动
我能领反正卡吗	咨询当下相关活动
如何领取反正卡	咨询当下相关活动
你好！在哪里领取反正卡？谢谢！	咨询当下相关活动
反正卡怎么弄的	咨询当下相关活动
怎么使用反正卡	咨询当下相关活动
反正卡是啥呢	咨询当下相关活动
反正卡是啥玩意	咨询当下相关活动
反正卡怎么激活	咨询当下相关活动
给我一张反正卡	咨询当下相关活动
反正卡怎么使用	咨询当下相关活动
反正卡是怎么用	咨询当下相关活动
反正卡怎么申请	咨询当下相关活动
反正卡什么意思？	咨询当下相关活动
反正卡完全不能领是什么情况	咨询当下相关活动
反正卡根本领不了，假的？	咨询当下相关活动
反正卡啥东西哦	咨询当下相关活动
什么是反正卡	咨询当下相关活动
反增卡怎么领取	咨询当下相关活动
反增卡，怎么使用？	咨询当下相关活动
请问反增卡要怎么激活	咨询当下相关活动
反增卡是怎么领取的	咨询当下相关活动
我的反增卡无法使用，为什么？	咨询当下相关活动
反增卡怎么领取呢?	咨询当下相关活动
请问一下你们那个反增卡是怎么领的	咨询当下相关活动
反增卡是什么？	咨询当下相关活动
领取会员反增卡	咨询当下相关活动
反增卡是什么	咨询当下相关活动
我能领反增卡吗	咨询当下相关活动
如何领取反增卡	咨询当下相关活动
你好！在哪里领取反增卡？谢谢！	咨询当下相关活动
反增卡怎么弄的	咨询当下相关活动
怎么使用反增卡	咨询当下相关活动
反增卡是啥呢	咨询当下相关活动
反增卡是啥玩意	咨询当下相关活动
反增卡怎么激活	咨询当下相关活动
给我一张反增卡	咨询当下相关活动
反增卡怎么使用	咨询当下相关活动
反增卡是怎么用	咨询当下相关活动
反增卡怎么申请	咨询当下相关活动
反增卡什么意思？	咨询当下相关活动
反增卡完全不能领是什么情况	咨询当下相关活动
反增卡根本领不了，假的？	咨询当下相关活动
反增卡啥东西哦	咨询当下相关活动
什么是反增卡	咨询当下相关活动
反赠卡怎么领取	咨询当下相关活动
反赠卡，怎么使用？	咨询当下相关活动
请问反赠卡要怎么激活	咨询当下相关活动
反赠卡是怎么领取的	咨询当下相关活动
我的反赠卡无法使用，为什么？	咨询当下相关活动
反赠卡怎么领取呢?	咨询当下相关活动
请问一下你们那个反赠卡是怎么领的	咨询当下相关活动
反赠卡是什么？	咨询当下相关活动
领取会员反赠卡	咨询当下相关活动
反赠卡是什么	咨询当下相关活动
我能领反赠卡吗	咨询当下相关活动
如何领取反赠卡	咨询当下相关活动
你好！在哪里领取反赠卡？谢谢！	咨询当下相关活动
反赠卡怎么弄的	咨询当下相关活动
怎么使用反赠卡	咨询当下相关活动
反赠卡是啥呢	咨询当下相关活动
反赠卡是啥玩意	咨询当下相关活动
反赠卡怎么激活	咨询当下相关活动
给我一张反赠卡	咨询当下相关活动
反赠卡怎么使用	咨询当下相关活动
反赠卡是怎么用	咨询当下相关活动
反赠卡怎么申请	咨询当下相关活动
反赠卡什么意思？	咨询当下相关活动
反赠卡完全不能领是什么情况	咨询当下相关活动
反赠卡根本领不了，假的？	咨询当下相关活动
反赠卡啥东西哦	咨询当下相关活动
什么是反赠卡	咨询当下相关活动
反憎卡怎么领取	咨询当下相关活动
反憎卡，怎么使用？	咨询当下相关活动
请问反憎卡要怎么激活	咨询当下相关活动
反憎卡是怎么领取的	咨询当下相关活动
我的反憎卡无法使用，为什么？	咨询当下相关活动
反憎卡怎么领取呢?	咨询当下相关活动
请问一下你们那个反憎卡是怎么领的	咨询当下相关活动
反憎卡是什么？	咨询当下相关活动
领取会员反憎卡	咨询当下相关活动
反憎卡是什么	咨询当下相关活动
我能领反憎卡吗	咨询当下相关活动
如何领取反憎卡	咨询当下相关活动
你好！在哪里领取反憎卡？谢谢！	咨询当下相关活动
反憎卡怎么弄的	咨询当下相关活动
怎么使用反憎卡	咨询当下相关活动
反憎卡是啥呢	咨询当下相关活动
反憎卡是啥玩意	咨询当下相关活动
反憎卡怎么激活	咨询当下相关活动
给我一张反憎卡	咨询当下相关活动
反憎卡怎么使用	咨询当下相关活动
反憎卡是怎么用	咨询当下相关活动
反憎卡怎么申请	咨询当下相关活动
反憎卡什么意思？	咨询当下相关活动
反憎卡完全不能领是什么情况	咨询当下相关活动
反憎卡根本领不了，假的？	咨询当下相关活动
反憎卡啥东西哦	咨询当下相关活动
什么是反憎卡	咨询当下相关活动
全勤奖	咨询当下相关活动
全勤奖怎么申请	咨询当下相关活动
全勤彩金怎么领	咨询当下相关活动
怎么申请全勤奖	咨询当下相关活动
领全勤奖	咨询当下相关活动
我要申请全勤奖	咨询当下相关活动
全勤优惠是什么	咨询当下相关活动
怎么领申请全勤彩金	咨询当下相关活动
有全勤的优惠吗	咨询当下相关活动
我申请全勤彩金	咨询当下相关活动
申请全勤彩金	咨询当下相关活动
领取全勤彩金	咨询当下相关活动
换取全勤彩金	咨询当下相关活动
怎么兑换全勤彩金	咨询当下相关活动
怎么参加全勤活动	咨询当下相关活动
全勤活动怎么对话	咨询当下相关活动
全勤活动有限制吗	咨询当下相关活动
我怎么参加全勤活动	咨询当下相关活动
要如何请取全勤彩金	咨询当下相关活动
给我全勤彩金	咨询当下相关活动
哪边可以领取全勤金	咨询当下相关活动
有全勤奖活动吗	咨询当下相关活动
全勤奖有什么限制	咨询当下相关活动
