周年彩金活动怎么各种理由不发放	咨询当下相关活动
亲，存送我不知道怎么办	咨询当下相关活动
是不是可以申请1000送88	咨询当下相关活动
是不是可以申请当日存1000送88	咨询当下相关活动
请问一下你们这游戏是否真像活动介绍的一样	咨询当下相关活动
申请久安存款红包	咨询当下相关活动
..申请充值就送钱的优惠活动	咨询当下相关活动
我要申请西天取经充值就送钱的活动.!	咨询当下相关活动
存款赠送	咨询当下相关活动
我申请123	咨询当下相关活动
我申请123彩金	咨询当下相关活动
没送彩金。	咨询当下相关活动
签到彩金无法转入到底是个什么意思？	咨询当下相关活动
邮箱看到送18	咨询当下相关活动
麻烦帮我查查看，我可以领取的优惠	咨询当下相关活动
你好啊七夕搭鹊桥这个活动中的神秘宝箱彩金需要多少倍流水啊谢谢	咨询当下相关活动
你好。新玩家申请存100送8的彩金	咨询当下相关活动
每日存送	咨询当下相关活动
每日存送优惠	咨询当下相关活动
每日存送活动	咨询当下相关活动
申请存100赠8的活动	咨询当下相关活动
每日存送活动	咨询当下相关活动
每日优惠活动	咨询当下相关活动
签到彩金	咨询当下相关活动
存100到账216的活动怎么申请？	咨询当下相关活动
新注册有送吗	咨询当下相关活动
接到电话说我帐户上有彩金可是没不	咨询当下相关活动
您好 请问签到彩金需要多少流水可以提款	咨询当下相关活动
这个签到彩金，怎么使用	咨询当下相关活动
那我的签到彩金呢	咨询当下相关活动
签到彩金余额没有啊！之前还有52呢	咨询当下相关活动
有什么优惠我可以申请	咨询当下相关活动
申请存款红包	咨询当下相关活动
申请存款红包	咨询当下相关活动
客服打电话给我，找在线客服领取彩金	咨询当下相关活动
我已经申请过了PT的30送21，还能不能申请老虎机的30送21	咨询当下相关活动
充值送。	咨询当下相关活动
帮我看下我有什么可以申请的。	咨询当下相关活动
不是说新用户存款了在站内信里领取88么	咨询当下相关活动
会员日领取	咨询当下相关活动
我领取的七夕彩金呢？	咨询当下相关活动
申请个活跃彩金嘛输完了	咨询当下相关活动
请问限时优惠存100%送100%的活动现在还可以进行充值申请吗？	咨询当下相关活动
限时优惠充值100%送100%的活动现在还可以充值领取吗？	咨询当下相关活动
申请久安钱包下载彩金	咨询当下相关活动
申请久安钱包下载彩金	咨询当下相关活动
申请久安钱包APP彩金	咨询当下相关活动
您好 我想问一下每天存送的PT 30+21 可不可以打古怪猴子呢	咨询当下相关活动
不说有PT存30送21吗	咨询当下相关活动
PT 30+21的存送能不能玩古怪猴子	咨询当下相关活动
签到彩金无法转入	咨询当下相关活动
存100到账200么	咨询当下相关活动
有没有存款红包啊	咨询当下相关活动
钱包彩金	咨询当下相关活动
老虎机钱包需要到多少才能提现	咨询当下相关活动
每日存送活动	咨询当下相关活动
签到彩金怎么才能用	咨询当下相关活动
你好啊七夕搭鹊桥这个活动中的神秘宝箱彩金需要多少倍流水啊谢谢	咨询当下相关活动
秒存优惠	咨询当下相关活动
存100到账200么	咨询当下相关活动
领取68彩金	咨询当下相关活动
签到的钱为什么无法转出来？	咨询当下相关活动
你好签到彩金不可以用吗	咨询当下相关活动
你好我申请彩金	咨询当下相关活动
申请不了存送啊	咨询当下相关活动
无法申请存送	咨询当下相关活动
签到的彩金可以玩bb电子吗	咨询当下相关活动
请问我站内信里面说我8月21号存200送5个红包，请问怎么领取	咨询当下相关活动
请问我站内信说8月21日存款200送5个红包，请问怎么领取	咨询当下相关活动
你们的签到里的钱怎么无法使用呢	咨询当下相关活动
签到金怎么转到账户	咨询当下相关活动
我的签到彩金没有余额了呢	咨询当下相关活动
52元签到彩金盈利多少出款	咨询当下相关活动
申请西天取经	咨询当下相关活动
申请优惠	咨询当下相关活动
帮我看下是不是可以领存款红包？	咨询当下相关活动
你们跟我发邮件说送我36-88怎么领取了	咨询当下相关活动
绑定完了，领取彩金	咨询当下相关活动
申请了12快	咨询当下相关活动
存30送21的活动需要几倍流水才能提款	咨询当下相关活动
签到彩金能不能玩游戏	咨询当下相关活动
我介绍朋友在提示的网址注册，我怎么领取132奖金	咨询当下相关活动
申请彩金	咨询当下相关活动
88会员礼金也么申请	咨询当下相关活动
申请200送18充值就送钱活动	咨询当下相关活动
问一下签到余额怎么使用	咨询当下相关活动
尊宝千百倍无限之战的奖金派发完毕了!	咨询当下相关活动
会员周年日怎么查询？	咨询当下相关活动
有哪些优惠活动	咨询当下相关活动
论坛优惠活动	咨询当下相关活动
优惠活动	咨询当下相关活动
积分有用没？	咨询当下相关活动
积分有用吗	咨询当下相关活动
今日优惠	咨询当下相关活动
每日优惠	咨询当下相关活动
彩金领取	咨询当下相关活动
存款彩金	咨询当下相关活动
刚才客服给我打电话说让我过来领彩金	咨询当下相关活动
你好，送的彩金可以在哪游戏	咨询当下相关活动
彩金可以在哪游戏？	咨询当下相关活动
我是你们短信邀请申请彩金	咨询当下相关活动
我想问一下，签到的彩金，需要几倍流水才可以出款啊	咨询当下相关活动
参加充值送彩金活动	咨询当下相关活动
充值就送现金	咨询当下相关活动
充值就送钱活动	咨询当下相关活动
你好，凭截图领68菜首存50道长118仅限10名高返水不掉级，加v信zunbao05领网之zunbao05点com驻册。xHf	咨询当下相关活动
下载永安钱包APP怎么申请免费彩金	咨询当下相关活动
你们给我发邮箱说有送88彩金	咨询当下相关活动
你们给我发邮箱说有送88彩	咨询当下相关活动
PT存100送50那个限制游戏告诉我	咨询当下相关活动
申请132彩金	咨询当下相关活动
申请18彩金	咨询当下相关活动
领取彩金	咨询当下相关活动
申请存钱红包	咨询当下相关活动
我申请123	咨询当下相关活动
会员日领取	咨询当下相关活动
不是说有会员礼金88吗	咨询当下相关活动
有哪些优惠	咨询当下相关活动
申请存款彩金	咨询当下相关活动
您好，在吗，请问我站内信说的我8月21日存款200送5个红包，请问怎么领取呢	咨询当下相关活动
不是说给我赠送彩金嘛	咨询当下相关活动
你们给我打电话说给我曾送了彩金嘛 怎么没有	咨询当下相关活动
你们客服打电话给我说给我送也没有嘛	咨询当下相关活动
最新优惠	咨询当下相关活动
月优惠	咨询当下相关活动
送彩金	咨询当下相关活动
我申请的老虎机存款100送50的优惠  怎么钱不见了	咨询当下相关活动
短信收到送42	咨询当下相关活动
申请88彩金	咨询当下相关活动
申请彩金	咨询当下相关活动
10元以上100%128820倍128%128元25倍	咨询当下相关活动
申请了PT平台后，还可以申请SLO 老虎机平台的优惠嘛？	咨询当下相关活动
填卷送彩金什么时候送	咨询当下相关活动
怎么填问卷	咨询当下相关活动
签到的彩金怎么玩	咨询当下相关活动
领取存款全勤彩金	咨询当下相关活动
领取千倍百倍彩金	咨询当下相关活动
怎么领取答题彩金啊	咨询当下相关活动
如何领取千倍百倍救援金	咨询当下相关活动
你好请问怎么领取千倍百倍救援金呢	咨询当下相关活动
不是说存款送的吗	咨询当下相关活动
你好我收到邮件存50送50 有什么活动要求了	咨询当下相关活动
咋申请问卷彩金啊	咨询当下相关活动
填尊宝问卷咋领取彩金啊	咨询当下相关活动
申请彩金88	咨询当下相关活动
申请88彩金	咨询当下相关活动
我邮箱收到送彩金	咨询当下相关活动
周年日	咨询当下相关活动
注册成功，并下截了，请问奖金怎么还未到帐记	咨询当下相关活动
注册了，下截了，奖金好久到帐呢？	咨询当下相关活动
我签到红包的钱不能转出来吗	咨询当下相关活动
填问圈，送彩金，怎么整啊	咨询当下相关活动
填问圈，送彩金，在哪里啊？	咨询当下相关活动
申请一下优惠	咨询当下相关活动
问答卷提交之后怎样申请彩金	咨询当下相关活动
问答卷提交了之后怎么申请彩金	咨询当下相关活动
填问卷领彩金	咨询当下相关活动
收到邮件。送88彩金，	咨询当下相关活动
问卷在哪？	咨询当下相关活动
填问卷在哪找？	咨询当下相关活动
你们发信息存50送118	咨询当下相关活动
打电话给我领取红利是不是真的	咨询当下相关活动
问卷调查彩金我去哪取	咨询当下相关活动
请问填空领取彩金是在哪里填的	咨询当下相关活动
收到邮件！申请彩金	咨询当下相关活动
来尊宝填问卷也能领彩金!您的建议被采纳,惊喜彩金等着您!下载尊宝APP立即领取12-88彩金,无需联系客服申请!	咨询当下相关活动
填问卷在哪里	咨询当下相关活动
申请邮件邀请88彩金	咨询当下相关活动
我提的建议被采纳，所以让我来领彩金	咨询当下相关活动
客服请问在哪里填问卷？	咨询当下相关活动
为什么我下载没有彩金	咨询当下相关活动
来尊宝填问卷也能领彩金! 您的建议被采纳,惊喜彩金等着您!下载尊宝APP立即领取12-88彩金,无需联系客服申请!	咨询当下相关活动
存10送18？。	咨询当下相关活动
支付宝，网银和存好多送彩金	咨询当下相关活动
说送我132	咨询当下相关活动
申请七夕彩金	咨询当下相关活动
申请36送88彩金	咨询当下相关活动
签到彩金怎么玩	咨询当下相关活动
自助彩金我看到有12块为啥账户没钱	咨询当下相关活动
怎么领不到彩金	咨询当下相关活动
我收到邮箱申请彩金88	咨询当下相关活动
我收到邮箱可以申请彩金吗	咨询当下相关活动
你好昨天你们打电话给我说有彩金送给我	咨询当下相关活动
彩金呢	咨询当下相关活动
那个问卷调查送彩金怎么申请	咨询当下相关活动
回答问卷送彩金	咨询当下相关活动
请问下载送彩金	咨询当下相关活动
怎么没有彩金	咨询当下相关活动
我申请彩金	咨询当下相关活动
那也就是说我不能申请优惠了，为什么天天给我发邮件呢	咨询当下相关活动
存送128是不是要第一次存送啊	咨询当下相关活动
申请50+118彩金	咨询当下相关活动
申请周年日红包	咨询当下相关活动
申请千百倍奖金	咨询当下相关活动
存送%128都可以参加吗	咨询当下相关活动
自助存送里面的首存%128是可以参加的吗	咨询当下相关活动
我要申请彩金	咨询当下相关活动
怎么申请存30送21	咨询当下相关活动
你好我要申请彩金	咨询当下相关活动
我要申请彩金	咨询当下相关活动
申请不了彩金	咨询当下相关活动
我为什么申请不了彩金	咨询当下相关活动
存送128%最低存款多少。所有会员都能参加	咨询当下相关活动
你们不是说填问卷给彩金怎么填啊	咨询当下相关活动
我想问一下填问卷给彩金怎么填在哪填啊	咨询当下相关活动
问卷拜金什么时候审核完，什么时候到账	咨询当下相关活动
怎么申请亏损金	咨询当下相关活动
短信告诉我我有彩金	咨询当下相关活动
签到的额度怎么转出来	咨询当下相关活动
七夕活动	咨询当下相关活动
七夕送彩金	咨询当下相关活动
七夕情人节活动七天领取完毕怎样申请活动	咨询当下相关活动
你好七夕活动7天领取完毕	咨询当下相关活动
申请充值200送18红包	咨询当下相关活动
填写客服问卷领彩金	咨询当下相关活动
问卷彩金	咨询当下相关活动
存50到帐118还有这个优惠吗	咨询当下相关活动
存50到帐118吗	咨询当下相关活动
请问现在还可以存50送吗	咨询当下相关活动
我冲这么多钱了，怎么没有福利	咨询当下相关活动
你好打电话说我有免费彩金可以领取吗	咨询当下相关活动
你好！看到站内信存50到账118这个优惠流水多少呢？	咨询当下相关活动
存50到账118	咨询当下相关活动
你这边是不是存款30送21	咨询当下相关活动
存款30送21？	咨询当下相关活动
你好  存款30送21在哪里申请》？	咨询当下相关活动
你好问卷答题彩金在哪领	咨询当下相关活动
下载九安钱包免费送彩金呀？	咨询当下相关活动
申请彩金	咨询当下相关活动
我要要点福利可以吗	咨询当下相关活动
填问卷送彩金	咨询当下相关活动
申请彩金	咨询当下相关活动
为什么我得到不可以领取彩金	咨询当下相关活动
请问签到彩金不能用吗	咨询当下相关活动
申请尊宝千百倍无限之战的奖金	咨询当下相关活动
申请18元彩金	咨询当下相关活动
申请首存30送21的优惠	咨询当下相关活动
积分商城什么时候开始？	咨询当下相关活动
申请首存30送20的优惠	咨询当下相关活动
有什么优惠活动	咨询当下相关活动
申请周年日彩金	咨询当下相关活动
请问pt首存送128%我可以申请吗	咨询当下相关活动
请问pt首存送128%是什么意思	咨询当下相关活动
千百倍怎么申请	咨询当下相关活动
千百倍怎么申请  给多少	咨询当下相关活动
申请118元彩金	咨询当下相关活动
我收到短信说存50到账118.怎么申请	咨询当下相关活动
问卷填写	咨询当下相关活动
申请118	咨询当下相关活动
申请存款彩金	咨询当下相关活动
充五十送多少	咨询当下相关活动
申请生日彩金	咨询当下相关活动
亲我要申请千倍百倍奖	咨询当下相关活动
你好，签到奖金可以玩啥游戏呢	咨询当下相关活动
存款送红包的活动还有吗	咨询当下相关活动
申请久安存款100送18	咨询当下相关活动
彩金可以玩什么游戏	咨询当下相关活动
那个彩金能玩什么游戏	咨询当下相关活动
彩金多久到账	咨询当下相关活动
查一下我有什么优惠可以领取谢谢	咨询当下相关活动
存款彩金怎么申请	咨询当下相关活动
你好，能申请存款红包吗	咨询当下相关活动
存送优惠！是什么时候刷新！	咨询当下相关活动
我刚领取了个荷花可是兑换码我没看到就没了	咨询当下相关活动
宝箱开不了。	咨询当下相关活动
我宝箱怎么打不开。	咨询当下相关活动
信息收到存50到118请问是否有这回事呀?	咨询当下相关活动
昨天存款今天有活动没有	咨询当下相关活动
申请彩金	咨询当下相关活动
冲50到账118怎么申请啊？	咨询当下相关活动
收到短信存五十到账118	咨询当下相关活动
会员周年日彩金领取	咨询当下相关活动
你好，申请88彩金	咨询当下相关活动
邮箱看见的，申请88彩金	咨询当下相关活动
申请存款彩金怎么没有动静	咨询当下相关活动
自助存送的钱没看到看	咨询当下相关活动
每日存款礼金	咨询当下相关活动
申请存款礼金	咨询当下相关活动
申请存款送彩金	咨询当下相关活动
签到4块不能玩游戏吗	咨询当下相关活动
千百倍奖金	咨询当下相关活动
您好千百倍奖金怎么领取	咨询当下相关活动
我昨晚收到问卷邮件，我应该怎样领取29彩金？	咨询当下相关活动
存200送18元存1000送88元5倍老虎机任意平台未达要求且新注册用户存100送8元存1000送38元5倍老虎机任意平台	咨询当下相关活动
24小时客服申请此优惠	咨询当下相关活动
pt存30送21	咨询当下相关活动
自助优惠	咨询当下相关活动
我收到邮件说送88	咨询当下相关活动
不是刚刚注册的账号有彩金送吗？	咨询当下相关活动
申请千百倍彩金	咨询当下相关活动
千百倍彩金	咨询当下相关活动
申请千百倍彩金	咨询当下相关活动
你们给我的信息说送我88彩金	咨询当下相关活动
有没有签到全勤奖	咨询当下相关活动
我已经发送短信了，可是点击领取啊彩金确没反应	咨询当下相关活动
收到邮件找客户领取18	咨询当下相关活动
会员日周年彩金	咨询当下相关活动
下载礼金怎么领不了	咨询当下相关活动
我怎么领不到救济金	咨询当下相关活动
救济金怎么领	咨询当下相关活动
优惠款可以用吗	咨询当下相关活动
己存30怎么申请存送彩金？	咨询当下相关活动
存30送彩金申请	咨询当下相关活动
收到邮件88彩金	咨询当下相关活动
你家存款不是给钱吗？	咨询当下相关活动
邮箱彩金	咨询当下相关活动
申请59	咨询当下相关活动
请问我收到邮件，存50送50优惠，要打几倍流水呀，有游戏限制吗	咨询当下相关活动
申请彩金没给我	咨询当下相关活动
登陆就送128元？	咨询当下相关活动
帮我申请彩金！	咨询当下相关活动
请问有充值50送红包活动嘛	咨询当下相关活动
签到彩金怎么不可以玩游戏	咨询当下相关活动
实在是没有找到，麻烦你帮我看看领取12彩金打多少钱可以提款	咨询当下相关活动
你好刚刚领取了12彩金，怎么提款	咨询当下相关活动
收到信息，领取132彩金	咨询当下相关活动
收到邮箱说送18	咨询当下相关活动
今天到你们这里注册有活动？	咨询当下相关活动
我想问问会员日彩金领取方式	咨询当下相关活动
申请132	咨询当下相关活动
存款50到账118是吧	咨询当下相关活动
存款50到账118是吧	咨询当下相关活动
送彩金	咨询当下相关活动
申请充值200送18红包	咨询当下相关活动
申请彩金	咨询当下相关活动
如何激活彩金	咨询当下相关活动
我签到彩金如何激话	咨询当下相关活动
PT限时存送那些游戏不能玩	咨询当下相关活动
你们电话客服说领取什么优秀	咨询当下相关活动
刚才你们客服给我打电话说领取什么彩金	咨询当下相关活动
存30送21存100送50存500送160	咨询当下相关活动
存30送21存100送50存500送160	咨询当下相关活动
存200有18的红包啊	咨询当下相关活动
每日签到每日送	咨询当下相关活动
我只会玩百家乐，在QQ邮箱里看到的，我存款200，是不是到账400	咨询当下相关活动
领下存款红包	咨询当下相关活动
送点优惠	咨询当下相关活动
申请存款红包	咨询当下相关活动
送点··优惠	咨询当下相关活动
充···50有多少··	咨询当下相关活动
活跃彩金啊？	咨询当下相关活动
接到电话送彩金啊怎么没有添加？	咨询当下相关活动
支付宝存款优惠	咨询当下相关活动
申请了充30送21的钱去哪儿了	咨询当下相关活动
我刚刚申请了个充30送21的活动你帮我看看	咨询当下相关活动
下载久安钱包就送彩金嘛	咨询当下相关活动
领取18彩金	咨询当下相关活动
新注册的用户存钱给奖励吗	咨询当下相关活动
收到短信请截图领68	咨询当下相关活动
你好签到彩金能使用吗	咨询当下相关活动
我充了这么久都没打上去过能不能有点彩金或者优惠	咨询当下相关活动
申请彩金	咨询当下相关活动
你们电话客服每天打我电话，要我上游戏，送彩金我，	咨询当下相关活动
短信说了领26	咨询当下相关活动
您好，凭图领【26】首存50道长118限10名高返水不掉级威信zunbao01vip领网之https://zunbao89.com。FHI	咨询当下相关活动
你帮我申请一些下载aop彩金	咨询当下相关活动
你给我个彩金或者红包吧，反正没领到我不考虑存款	咨询当下相关活动
申请彩金	咨询当下相关活动
领88优惠彩金	咨询当下相关活动
签到余额能干嘛	咨询当下相关活动
我要申请优惠需要收你在短信	咨询当下相关活动
没有送我彩金啊	咨询当下相关活动
我新用户存款已经达到200以上不是送彩金	咨询当下相关活动
绑上银行卡了也没送彩金吗	咨询当下相关活动
真人娱乐有什么活动	咨询当下相关活动
已经下载了，送彩金？	咨询当下相关活动
亲，申请132彩金	咨询当下相关活动
填问卷是在哪里？	咨询当下相关活动
请问签到彩金多少可以出款呢	咨询当下相关活动
填表不是送彩金么	咨询当下相关活动
问卷奖金	咨询当下相关活动
那问卷奖金怎么领？	咨询当下相关活动
问卷问题	咨询当下相关活动
领取68	咨询当下相关活动
你好 在哪里领问卷彩金	咨询当下相关活动
在哪里领问卷彩金	咨询当下相关活动
领取彩金	咨询当下相关活动
我收到信息领回答问卷彩金	咨询当下相关活动
收到信息填问卷领彩金，请问是不是可以领取，这样领取	咨询当下相关活动
填问卷领彩金，是在那哈领	咨询当下相关活动
回答问卷另彩金	咨询当下相关活动
每个月的签到彩金，可以不要那么多的钱也能转入游戏就好了，可以吗？	咨询当下相关活动
填问卷彩金什么时候可以领取了	咨询当下相关活动
问卷彩金	咨询当下相关活动
彩金怎么没有	咨询当下相关活动
下载彩金我领不到呢	咨询当下相关活动
签到彩金怎么用	咨询当下相关活动
问卷彩金怎么领	咨询当下相关活动
我收到一个邮件说是能领38	咨询当下相关活动
申请彩金申请不了啊	咨询当下相关活动
还有什么优惠呀	咨询当下相关活动
间：2018-08-2612:06:41来尊宝填问卷也能领彩金!您的建议被采纳,惊喜彩金等着您!下载尊宝APP立即领取12-88彩金,无需联系客服申请!	咨询当下相关活动
下载久安钱包了怎么送彩金？	咨询当下相关活动
我昨天存款没有啥优惠吗今天给我的	咨询当下相关活动
你好，填写问答卷活动怎么申请	咨询当下相关活动
在那填写问卷呢	咨询当下相关活动
为什么我不能申请AP彩金	咨询当下相关活动
你好，你们这个优惠是怎么申请	咨询当下相关活动
充值送礼金	咨询当下相关活动
我收到你们的邮件说可以领取88彩金	咨询当下相关活动
申请邮件说的88彩金	咨询当下相关活动
我收到站内消息说我填问卷被采取可以领取12彩金，我不知道怎么领	咨询当下相关活动
请问30送21这些优惠最低存款多少可以申请	咨询当下相关活动
我收到邮箱说送88元彩金	咨询当下相关活动
在哪里答问卷啊	咨询当下相关活动
调查问卷在哪里答	咨询当下相关活动
问卷调查拿彩金怎么弄	咨询当下相关活动
问卷调查	咨询当下相关活动
填写问卷彩金在哪里领取呀？	咨询当下相关活动
没有送的福利吗	咨询当下相关活动
说我有多个白菜金没有领是什么意思啊？	咨询当下相关活动
投注也没优惠的	咨询当下相关活动
最新优惠	咨询当下相关活动
我首存300申请百分之128的优惠到账怎么只有128元了	咨询当下相关活动
请问我的问卷彩金怎么领取？	咨询当下相关活动
问卷彩金怎么领取	咨询当下相关活动
问卷彩金	咨询当下相关活动
填问卷领彩金	咨询当下相关活动
填问卷领彩金	咨询当下相关活动
申请回馈彩金	咨询当下相关活动
你们网站BBIN的糖果派对有没有注单奖和消除奖	咨询当下相关活动
问卷彩金	咨询当下相关活动
你好给我发邮箱说是送18到38元彩金啊	咨询当下相关活动
给我发邮箱说送18到38彩金	咨询当下相关活动
你能给我打电话说，我中彩金了	咨询当下相关活动
申请邮箱特别88	咨询当下相关活动
为什么我不能签到	咨询当下相关活动
前些问卷调查	咨询当下相关活动
我的问卷彩金呢？	咨询当下相关活动
问卷彩金呢	咨询当下相关活动
申请88	咨询当下相关活动
我申请彩金提示我完善资料，请问怎样操作？	咨询当下相关活动
我完善资料，请问怎样操作？	咨询当下相关活动
我申请彩金提示我完善资料，请问在哪完善，怎样操作？	咨询当下相关活动
那怎么申请彩金提示要我完善呢？	咨询当下相关活动
存款都没有优惠	咨询当下相关活动
怎么领取彩金？	咨询当下相关活动
我是新客户，我想申请优惠	咨询当下相关活动
发信息给我送38彩金给怎么送	咨询当下相关活动
发信息给我送38彩金给我怎么	咨询当下相关活动
你们客服打电话说有送彩金的 怎么没有？	咨询当下相关活动
收到邮件说问卷在哪里做啊	咨询当下相关活动
问卷在哪里做	咨询当下相关活动
送彩金的	咨询当下相关活动
领取周年日彩金	咨询当下相关活动
申请存1000送88	咨询当下相关活动
申请存1000送88红包	咨询当下相关活动
请问在那里问卷调查送彩金呀	咨询当下相关活动
刚才发的截图是说我喜获彩金哟	咨询当下相关活动
申请存款红包	咨询当下相关活动
今天有活动吗	咨询当下相关活动
申请存1千送88红包	咨询当下相关活动
有啥优惠	咨询当下相关活动
没有送福利吗	咨询当下相关活动
我的HYG里面的钱怎么转不出来了	转账咨询
PT里的钱转不出来	转账咨询
请问老虎机自助优惠那个SLOT存送了可以打MG游戏吗	转账咨询
pt转账主账户怎么转不了	转账咨询
怎么转到账户上阿	转账咨询
往PNG馆转找不到	转账咨询
户内转账里没有png	转账咨询
hyg的钱怎么转回	转账咨询
我为什么不能转账到pt	转账咨询
我的确没搞懂，我的额度在老虎机额度里面，我怎样才能把金币转出来去玩游戏啊	转账咨询
自助优惠路面slot是什么平台	转账咨询
您好  老虎机钱包可以玩什么游戏啊？	转账咨询
钱怎么转到AG真人里面	转账咨询
钱来捕鱼怎么转帐	转账咨询
钱来捕鱼怎么提现	转账咨询
钱来捕鱼怎么提	转账咨询
钱来捕鱼怎么转	转账咨询
怎么转钱来捕鱼	转账咨询
钱来捕鱼转帐怎么转	转账咨询
我不会转出钱来捕鱼	转账咨询
老虎机钱包的余额可以玩什么游戏	转账咨询
资金怎么转换	转账咨询
怎么资金转换	转账咨询
老虎机SLOT什么意思	转账咨询
玩MG把钱转到哪里	转账咨询
干嘛钱转不到游戏平台	转账咨询
pt转主帐户转不出来	转账咨询
我刚从主账户转3030到开元棋牌然后显示错误钱就没有了怎么回事？	转账咨询
怎么转不好bbin?	转账咨询
你好为什么我pt里面有钱，可以打开游戏钱又不在	转账咨询
请向我的老虎机钱包的款怎么转不走	转账咨询
老虎机钱包的钱怎么玩不了糖果派对	转账咨询
我转帐成功快三小时了，为何还没到帐？	转账咨询
我的尊宝帐号为'xys258，两个多小时前转帐给熊帅，人民币23元！到现在仍没到我的尊宝帐户宝，请求速解！	转账咨询
尊宝帐户里不见钱，我哪能户内转帐呢！	转账咨询
打渔的钱转不出来吗	转账咨询
申请的彩金显示到老虎机账户了。是哪个老虎机游戏都能玩么？	转账咨询
怎么把余额转到mg	转账咨询
那个老虎钱包里面的钱怎么转出来？	转账咨询
你好，转账里面怎么没有MG,怎么转呀	转账咨询
老虎机转账平台什么时候能好	转账咨询
不能户内转账，	转账咨询
户内怎么转不了账	转账咨询
现在不能转账	转账咨询
转钱进游戏游戏里面没有钱	转账咨询
我刚才转到老虎机厅的钱去哪里了呀我申请了一个存款100送50的优惠	转账咨询
怎么我签到12块转到平台去平台没有钱	转账咨询
SLOT可以玩什么游戏	转账咨询
SLOT是什么平台？	转账咨询
SLOT可以玩MG电子吗？	转账咨询
怎么把尊宝账户上的钱转到老虎机账号上	转账咨询
钱带pt里面，为什么进去没有啊	转账咨询
我DT平台为什么不能户内转账	转账咨询
我转账成功，但没有到	转账咨询
额度怎么转换	转账咨询
钱来捕鱼的钱冲完怎么退出来	转账咨询
钱来捕鱼里的钱怎么提出来	转账咨询
我户内转账转不了	转账咨询
我转不出来余额	转账咨询
我的是在老虎机账户里。为什么我进老虎机游戏没钱呢	转账咨询
在老虎机余额里就不用转换了吧	转账咨询
我转换不了余额	转账咨询
为什么我钱转不进AG	转账咨询
户内转账	转账咨询
怎么转帐	转账咨询
我不能户内转帐	转账咨询
账号密码忘了	账号解锁、忘记账号
账号冻结	账号解锁、忘记账号
用户名忘记了	账号解锁、忘记账号
你好，我的账户锁了	账号解锁、忘记账号
账号减冻	账号解锁、忘记账号
您好 忘记账号和密码了	账号解锁、忘记账号
忘记账号和密码	账号解锁、忘记账号
账号被禁用	账号解锁、忘记账号
账号冻结	账号解锁、忘记账号
禁用账号	账号解锁、忘记账号
我要禁用账号	账号解锁、忘记账号
账户和密码忘记	账号解锁、忘记账号
你好帮查下我开的账号	账号解锁、忘记账号
我号怎么被封了	账号解锁、忘记账号
我的账号被锁定了	账号解锁、忘记账号
帐号忘了，客服让我激活一下，也没加我微信	账号解锁、忘记账号
帐号被冻	账号解锁、忘记账号
我的账号怎么被冻结了	账号解锁、忘记账号
亲我的账号被冻结了麻烦你解冻一下谢谢！	账号解锁、忘记账号
我忘了账号密码	账号解锁、忘记账号
你们怎么封了我朋帐号	账号解锁、忘记账号
你好!我的账号被临时封了，请解邦下	账号解锁、忘记账号
帮我解下pt客户端	账号解锁、忘记账号
账号锁上了	账号解锁、忘记账号
忘记账号密码	账号解锁、忘记账号
被锁定了叫你解锁	账号解锁、忘记账号
我的账号被禁用了，昨天你们客服打过电话了，叫我上号找你们解绑	账号解锁、忘记账号
忘了账号	账号解锁、忘记账号
账号忘了	账号解锁、忘记账号
账号记不起了	账号解锁、忘记账号
启动账号	账号解锁、忘记账号
账号找回	账号解锁、忘记账号
你好账号密码错误被锁了	账号解锁、忘记账号
账号锁死	账号解锁、忘记账号
账号密码忘记了	账号解锁、忘记账号
账号锁死解锁	账号解锁、忘记账号
我的账号密码忘记了能跟我找回吗？	账号解锁、忘记账号
号找回	账号解锁、忘记账号
账户和密码忘记	账号解锁、忘记账号
你好帮我解锁吧	账号解锁、忘记账号
帐户解冻	账号解锁、忘记账号
忘记账号和密码	账号解锁、忘记账号
我的帐号刲了	账号解锁、忘记账号
帮我解冻，我账号冻结了	账号解锁、忘记账号
我登录账号忘了	账号解锁、忘记账号
我登录账号和密码忘了	账号解锁、忘记账号
能不能找到我以前的账号	账号解锁、忘记账号
麻烦你给我查询一下，我的账号	账号解锁、忘记账号
我账号忘记了	账号解锁、忘记账号
帮我找下账号	账号解锁、忘记账号
解除冻结	账号解锁、忘记账号
我的账户忘记了邮箱也忘记了能不能找回来	账号解锁、忘记账号
忘了账号了	账号解锁、忘记账号
请帮查一下账号密码都忘记了	账号解锁、忘记账号
你好，我的账户被锁死了。请帮我解锁一下吧。谢谢了	账号解锁、忘记账号
帐号被封	账号解锁、忘记账号
账号密码全忘了	账号解锁、忘记账号
麻烦帮我查一下我的游戏账号	账号解锁、忘记账号
帐号解锁	账号解锁、忘记账号
我的帐号查询	账号解锁、忘记账号
帐号记不得了	账号解锁、忘记账号
查询我的帐号	账号解锁、忘记账号
帮我看看我有没有你们这是账号	账号解锁、忘记账号
我的帐号锁定	账号解锁、忘记账号
我账户被冻结了	账号解锁、忘记账号
忘记账户和密码了	账号解锁、忘记账号
游戏账号忘记了	账号解锁、忘记账号
麻烦帮我解冻账号	账号解锁、忘记账号
我忘了我会员是多少了	账号解锁、忘记账号
账户和登录密码忘了	账号解锁、忘记账号
查询账号	账号解锁、忘记账号
我账号多次密码错误被锁了	账号解锁、忘记账号
我忘记游戏账号和密码了	账号解锁、忘记账号
我的账号和密码都忘记了 希望找回	账号解锁、忘记账号
自己不顾解锁账号，，你帮忙弄一下	账号解锁、忘记账号
账号被锁	账号解锁、忘记账号
账号锁定了	账号解锁、忘记账号
帐号解冻	账号解锁、忘记账号
找回账号	账号解锁、忘记账号
pt客户端帐号解冻	账号解锁、忘记账号
我是忘记账号	账号解锁、忘记账号
你好麻烦帮我查下账号 我忘了多少	账号解锁、忘记账号
忘记账号了	账号解锁、忘记账号
账号解冻	账号解锁、忘记账号
帐号被i临时冻结了，麻烦您给解冻一下	账号解锁、忘记账号
忘记账号和密码	账号解锁、忘记账号
忘记帐户怎么找回来```	账号解锁、忘记账号
忘了账号	账号解锁、忘记账号
账号解冻	账号解锁、忘记账号
帐号冻结了怎么办	账号解锁、忘记账号
不记得账号了	账号解锁、忘记账号
你好忘记以前的账号了	账号解锁、忘记账号
帐号忘记了	账号解锁、忘记账号
帐号被锁了	账号解锁、忘记账号
我的号怎么禁用了？	账号解锁、忘记账号
忘记账号和密码了	账号解锁、忘记账号
可以报手机号找帐号密码吗	账号解锁、忘记账号
账号被冻结了	账号解锁、忘记账号
我账号被冻结了我怎么登录啊	账号解锁、忘记账号
号被禁用什么意思？	账号解锁、忘记账号
你好我的账号忘记了	账号解锁、忘记账号
忘记帐号	账号解锁、忘记账号
我的号被锁了	账号解锁、忘记账号
解锁下账号	账号解锁、忘记账号
我账号锁了	账号解锁、忘记账号
怎么我的会员被禁用了？	账号解锁、忘记账号
我的账号密码忘了现在冻结了怎么办	账号解锁、忘记账号
我账号忘了	账号解锁、忘记账号
忘记账号怎么办	账号解锁、忘记账号
帳號忘了	账号解锁、忘记账号
给我查下游戏账号	账号解锁、忘记账号
账号怎么被锁	账号解锁、忘记账号
帐号被锁	账号解锁、忘记账号
忘记帐号	账号解锁、忘记账号
什么是老虎机	游戏咨询
什么是免费游戏	游戏咨询
免费游戏是什么	游戏咨询
老虎机怎么玩	游戏咨询
免费游戏是什么	游戏咨询
老虎机游戏	游戏咨询
手机客户端前面加什么？pt	游戏咨询
投注记录怎么查询	游戏咨询
什么游戏	游戏咨询
游戏赔付有问题	游戏咨询
怎么玩游戏啊	游戏咨询
你们网站没有六合彩么	游戏咨询
dt客户端账号前面加什么	游戏咨询
你们平台的游戏那些有累积奖迟	游戏咨询
pt客户端前面加什么字母开头	游戏咨询
dt游戏客户端前边加什么	游戏咨询
免费游戏是什么	游戏咨询
免费游戏怎么玩	游戏咨询
免费游戏怎么取的	游戏咨询
什么是免费游戏	游戏咨询
怎样才会有免费游戏	游戏咨询
你们有免费游戏嘛	游戏咨询
有免费游戏吗	游戏咨询
免费游戏怎么取得	游戏咨询
赌博游戏是什么	游戏咨询
什么是赌博游戏	游戏咨询
赌博游戏不计算流水，哪些是赌博游戏	游戏咨询
赌博游戏怎么玩	游戏咨询
赌博游戏不算流水吗	游戏咨询
赌博游戏在哪里	游戏咨询
哪里有赌博游戏	游戏咨询
Pt客户端开头字母是多少	游戏咨询
请问客户端pt前面加什么	游戏咨询
你们pt客户端前面加什么	游戏咨询
请问我想进AG电子游戏从哪里进啊	游戏咨询
登录前缀	游戏咨询
没有AG电子游戏吗	游戏咨询
pt客户端前面加什么	游戏咨询
老虎机怎么玩	游戏咨询
什么是免费游戏	游戏咨询
老虎机怎么下注	游戏咨询
pt出分游戏	游戏咨询
赌博游戏是什么	游戏咨询
赌博功能是什么?	游戏咨询
多旋转	游戏咨询
多旋转游戏	游戏咨询
查询一下没有开启的免费游戏	游戏咨询
如何查看之前游戏回放	游戏咨询
现在dt什么游戏出分	游戏咨询
pt手机app加什么字母	游戏咨询
尊宝pt前缀	游戏咨询
在登陆的时候账号前加缀什么？	游戏咨询
首页老虎机投注怎样进入	游戏咨询
你上面怎么没有，三倍猴子	游戏咨询
PT上面怎么没有，三倍猴子	游戏咨询
怎么没有，三倍猴子	游戏咨询
游戏平台从哪里进入啊	游戏咨询
赌博游戏是什么	游戏咨询
翻倍游戏是什么	游戏咨询
哪个游戏出分	游戏咨询
pt客户端前面加啥字母啊	游戏咨询
pt客户端登录账号前加什么字母	游戏咨询
我尊宝上的余额怎么才能玩游戏	游戏咨询
pt手机客户端登录账号前加不加前缀？	游戏咨询
找不到要玩的游戏	游戏咨询
没有mg吗	游戏咨询
请问登陆pt要在帐号前加什么字母	游戏咨询
PT平台，没有，三倍猴子，这个游戏嘛	游戏咨询
pt客户端登录前面要加什么不？	游戏咨询
客户端登录前面要加什么	游戏咨询
pt手机端大写字母	游戏咨询
PT客服端登录前加什么？	游戏咨询
怎么平台激活	游戏咨询
平台激活是什么	游戏咨询
你们pT游戏怎么没'有三倍猴子呢	游戏咨询
pt客户端登录加什么	游戏咨询
PT出分游戏推荐一下	游戏咨询
怎么激活账号	游戏咨询
请问登陆手机pt客户端要在账号前加什么字母	游戏咨询
AG真人	游戏咨询
QT里面的那个矿山探险的游戏怎么没勒	游戏咨询
老虎机游戏	游戏咨询
pt游戏前面加什么字母	游戏咨询
怎么找不到游戏平台？	游戏咨询
出分高	游戏咨询
你好帮我看下DT哪个好上分	游戏咨询
你好我想问下DT那些比较好上分	游戏咨询
游戏突然打的彩金没有了	游戏咨询
糖果派对在哪里	游戏咨询
三倍猴子PT里面怎么找不到了？	游戏咨询
疯狂麻将是哪个游戏里的	游戏咨询
疯狂麻将是哪个游戏里面的	游戏咨询
手机pt客服端登录要在账号前加什么吗	游戏咨询
PT手机客服端登录	游戏咨询
怎么激活钱包	游戏咨询
现在哪些平台游戏较出分	游戏咨询
mg 多旋转游戏只的是那些	游戏咨询
百家乐	游戏咨询
出分游戏	游戏咨询
怎么玩	游戏咨询
老虎机	游戏咨询
有什么游戏	游戏咨询
PT游戏进不去	游戏进不去
PNG游戏 怎么不能玩了呢 我在免费游戏中	游戏进不去
你们游戏平台怎么那么卡呢	游戏进不去
无法进入游戏怎么回事啊	游戏进不去
捕鱼打不开	游戏进不去
mg游戏为啥进不去	游戏进不去
MG游戏进不去	游戏进不去
进入游戏失败怎么回事	游戏进不去
你好，MG怎么玩不了	游戏进不去
mg进不去	游戏进不去
你们游戏能不能玩啊	游戏进不去
mg游戏现在不能玩吗	游戏进不去
您好！我怎么不能游戏？	游戏进不去
电子游戏平台，进去了不能玩	游戏进不去
手机网站里面的PT游戏怎么玩不了	游戏进不去
mg游戏无法进入	游戏进不去
Ag在进不去就赶紧给我退钱	游戏进不去
你好我现在为什么没法登录DT游戏里面	游戏进不去
我现在登录不了DT里面的游戏	游戏进不去
游戏经常登不上是什么问题，网络没有问题	游戏进不去
pt游戏打不开？	游戏进不去
进不了pt厅怎么回事	游戏进不去
有一个账号进不了bt怎么回事啊	游戏进不去
P七账号封了进不去游戏	游戏进不去
游戏也玩不了	游戏进不去
怎么玩不了沙巴的游戏呢	游戏进不去
怎么你们的游戏老是掉线	游戏进不去
这会PT有问题吗？怎么网址也打不开，pT客户端也玩不了	游戏进不去
亲，PT游戏怎么进不了	游戏进不去
游戏掉线进不去	游戏进不去
游戏掉线进不去	游戏进不去
PT游戏怎么进去。三陪猴子等都没有吗	游戏进不去
pt游戏玩不了是吗	游戏进不去
布法罗闪电战电脑端怎么玩不了	游戏进不去
玩不了游戏	游戏进不去
MG游戏玩不了	游戏进不去
游戏断线咋办	游戏进不去
游戏怎么链接不了了那	游戏进不去
游戏掉线进不去	游戏进不去
PNG游戏怎么玩不了？	游戏进不去
玩不了游戏	游戏进不去
不进免费游戏	游戏进不去
多彩水果怎么不进免得游戏	游戏进不去
现在游戏都玩不了啊？	游戏进不去
游戏上不去了吗	游戏进不去
AG为什么进不去？	游戏进不去
为啥进去加载游戏失败？	游戏进不去
你好，我怎么打不起MG的游戏呢	游戏进不去
为什么pt馆玩不了	游戏进不去
你好，我的app客户端中mg游戏不能玩，显示无法加载啊，怎么回事啊	游戏进不去
在pt游戏界面显示“你在我们的casinomobile客户端有未完成的游戏”，可以帮我查下具体是那个游戏吗？	游戏进不去
我为什么进入游戏打不了。是怎么回事	游戏进不去
刚才是怎么回事，我玩的好好的会掉线	游戏进不去
pt怎么不能游戏啊	游戏进不去
为什么QT打不开呢	游戏进不去
我进入游猎炙热免费局还没完就进不去了	游戏进不去
dT世界杯玩不了了	游戏进不去
怎么我进不去p t娱乐	游戏进不去
pt进不去了	游戏进不去
游戏卡	游戏进不去
casino mobile有个未完成的游戏	游戏进不去
有未完成的游戏	游戏进不去
casinomobile有个未完成的有戏	游戏进不去
有游戏未完成	游戏进不去
pt有游戏未完成	游戏进不去
帮我查查哪个游戏未完成	游戏进不去
怎么修改手机号码	修改账号资料
我绑定的手机换号了，得怎么更换啊	修改账号资料
注册绑定的姓名被修改掉了	修改账号资料
可以修改手机号码吗？以前那个号码没用了	修改账号资料
可以更换手机号吗	修改账号资料
注册的手机号能修改吗？	修改账号资料
注册时手机号填错了怎么办？	修改账号资料
更改手机号码	修改账号资料
我新注册了帐号但输不了名字	修改账号资料
我要修改手机号码	修改账号资料
修改电话号码	修改账号资料
手机号码能不能改	修改账号资料
怎样修改手机号	修改账号资料
更换手机号	修改账号资料
修改手机号码	修改账号资料
你好可以修改手机号码吗	修改账号资料
修改电话号码	修改账号资料
为什么我那个绑定不了真实姓名	修改账号资料
能修改手机号码吗	修改账号资料
我可以把手机号码换一下吗，以前号码不用了	修改账号资料
休改一下手机号码	修改账号资料
你好，我想修改电话号码，怎么修改？	修改账号资料
想领取生日礼金需要完善资料，请问在哪里完善的	修改账号资料
请问可不可以在基本信息中把电话号码变动一下，因为我留的电话号码错了。	修改账号资料
手机号码不用了改不了我怎么领取app彩金啊	修改账号资料
修改手机号	修改账号资料
修改手机号码	修改账号资料
怎么修改电话号码	修改账号资料
怎么更换注册手机号码	修改账号资料
在不电话号想换可以吗	修改账号资料
变更联系电话	修改账号资料
不能输入名字	修改账号资料
为什么我的姓名填写不了	修改账号资料
我想修改手机号	修改账号资料
更换绑定手机号码	修改账号资料
我想更换手机号	修改账号资料
我要修改手机号	修改账号资料
我要更改手机号码	修改账号资料
手机号码可以改不	修改账号资料
想改一下手机号	修改账号资料
你好我注册那电话不用了可以修改吗？	修改账号资料
修改手机号码	修改账号资料
你好，我电话号码输入错了，请问可以修改吗	修改账号资料
手机填错了，怎么更改	修改账号资料
怎么修改手机号	修改账号资料
你好，我手机号码换了，怎么修改	修改账号资料
更改电话号码	修改账号资料
修改手机号码	修改账号资料
可不可以帮我改哈电话号码	修改账号资料
我修改手机号	修改账号资料
我想修改一下电话号码怎么弄啊？	修改账号资料
注册姓名可以修改吗？	修改账号资料
手机号码怎么更换	修改账号资料
可以修改手机号码吗	修改账号资料
我想修改电话号码	修改账号资料
怎么修改手机号	修改账号资料
修改手机号码	修改账号资料
修改手机号码	修改账号资料
修改手机号码	修改账号资料
我手机号码填错能修改吗	修改账号资料
我要完善资料怎么真实姓名的栏目点击没有反应？	修改账号资料
注册资料生日填错了可以修改吗？	修改账号资料
我的手机收不到验证码？我想查询下我是不是没注意把号码写错了	修改账号资料
我要修改手机号码	修改账号资料
修改QQ邮箱	修改账号资料
我电话号码甜错一个数字了	修改账号资料
我要更改绑定手机号	修改账号资料
修改手机号码	修改账号资料
修改注册电话	修改账号资料
帮我跟改电话号码	修改账号资料
帮我跟改电话号码	修改账号资料
手机号绑错了怎么办	修改账号资料
电话号码绑错了怎么办	修改账号资料
你好，我的名字打错了，可以修改吗	修改账号资料
你好我修改电话号码怎么修改	修改账号资料
手机号错了	修改账号资料
我的，我的个人中心，姓名怎么才能把 真名填上	修改账号资料
修改手机号	修改账号资料
更换手机号码	修改账号资料
修改手机号	修改账号资料
你好，手机号码停用了，帮我改下	修改账号资料
手机号码填错啦	修改账号资料
更改账户名字的邮件已发到客服	修改账号资料
要解绑手机号能解吗	修改账号资料
解绑手机号	修改账号资料
你好我需要改一下电话号码怎么更改	修改账号资料
解绑手机号	修改账号资料
我要解绑我的电话	修改账号资料
我要解绑我的手机号	修改账号资料
我要解绑手机号	修改账号资料
我要解绑邮箱号	修改账号资料
我要解绑我的邮箱	修改账号资料
帮我解绑手机号	修改账号资料
手机号可以解绑不	修改账号资料
您好 请问你们平台AG游戏在维护吗·、	系统维护状况说明
在维护，怎么充值？	系统维护状况说明
bbin维护到什么时候	系统维护状况说明
SLOT平台转账什么时间维护好啊？	系统维护状况说明
slot在维护，不能转账吗	系统维护状况说明
什么时候能维护完	系统维护状况说明
你们游戏维护怎么不通知我那	系统维护状况说明
你们那个老虎机转账要维护好久嘛	系统维护状况说明
入帐维护？	系统维护状况说明
bbin在维护吗？转不进去款？	系统维护状况说明
维护多久	系统维护状况说明
密码被锁了	忘记密码
密码忘了	忘记密码
你好，我密码找回了，然后官方发给我一个数字密码，我想修改密码，系统提示我旧密码不正确，什么问题？	忘记密码
不好意思我需要重置密码	忘记密码
我忘记登陆密码	忘记密码
你好，我密码找回了，然后官方发给我一个数字密码，我想修改密码，系统提示我旧密码不正确，什么问题？	忘记密码
找回密码手机和邮箱不用了	忘记密码
我密码忘了	忘记密码
我密码忘了	忘记密码
我修改密码怎么错误呢	忘记密码
我刚注册一个账号把密码忘了怎么办	忘记密码
密码找回	忘记密码
你好，我密码找回了，然后官方发给我一个数字密码，我想修改密码，系统提示我旧密码不正确，什么问题？	忘记密码
为什么我手机号码找回密码 却收不到验证码呢？	忘记密码
我登录密码忘了	忘记密码
密码忘记	忘记密码
密码忘记手机收不到信息	忘记密码
登录密码忘记了	忘记密码
我密码忘了输入次数过多冻结了	忘记密码
登录密码忘记了	忘记密码
登录密码忘记了	忘记密码
密码忘记了	忘记密码
找回密码提示用户信息错误指的是账号吗	忘记密码
你好我密码忘了	忘记密码
你好我刚刚注册账号注册好了但是输入密码错了，登陆不了怎么办	忘记密码
密码忘了	忘记密码
忘记登录密码	忘记密码
忘记登陆密码	忘记密码
忘记密码帐号被锁定了	忘记密码
密码忘记	忘记密码
忘记密码找回说我信息错误	忘记密码
登录密码忘了	忘记密码
密码多次输错帮我解冻	忘记密码
找回密码	忘记密码
密码忘记了	忘记密码
忘记密码被锁	忘记密码
密码忘了	忘记密码
忘記密碼	忘记密码
我的账号，和登录密码都忘了	忘记密码
忘记登入密码	忘记密码
我提款时说我登录密码错误	忘记密码
忘记登录密码	忘记密码
密码忘记了，能重置吗	忘记密码
邮箱没收到密码啊	忘记密码
你好！！找回密码	忘记密码
的登录密码忘了	忘记密码
邮箱找回密码，为何邮箱收不到邮件？	忘记密码
我要改变密码	忘记密码
注册送132	体验金咨询
领取特邀注册彩金	体验金咨询
收到邮件注册送132	体验金咨询
请问一下注册是不是送彩金	体验金咨询
注册是送18彩金	体验金咨询
怎么我把帐号注册好了都没彩金呢	体验金咨询
开户可领彩金	体验金咨询
您好我邮箱收到邀请说注册可以领取132彩金388可以提款	体验金咨询
我申请注册彩金123	体验金咨询
注册送彩金	体验金咨询
新注册送体验金怎么领？	体验金咨询
我绑定银行卡了怎么申请体验金	体验金咨询
注册送彩金怎么没有送	体验金咨询
注册彩金	体验金咨询
邮箱收到邮件注册送彩金88	体验金咨询
我手机验证码无论语音还是短信都收不到	体验金咨询
注册送彩金？	体验金咨询
注册送88？	体验金咨询
你们特邀我注册领取132无需流水打到388提款	体验金咨询
为什么注册彩金，app下载彩金我都领取不了	体验金咨询
申请注册彩金	体验金咨询
新注册会员的彩金可以玩彩票不	体验金咨询
体验金可以玩彩票游戏吗	体验金咨询
新注册有奖金	体验金咨询
开户彩金	体验金咨询
申请开户彩金	体验金咨询
注册送彩金吗	体验金咨询
注册彩金邮箱里面能不能收	体验金咨询
刚下载注册还有彩金吗	体验金咨询
注册金	体验金咨询
手机故障收不到短信	体验金咨询
收到邮箱注册送132	体验金咨询
收到邮箱注册送132	体验金咨询
我想申请注册彩金	体验金咨询
我刚才注册的账号，准备玩会，怎么我下载完APP申请彩金显示注册信息重复什么情况，我从来没注册过你们的网站账号啊	体验金咨询
邮箱特邀注册送88彩金	体验金咨询
新开户有彩金拿吗	体验金咨询
自助彩金显示信息信息重复	体验金咨询
新注册有彩金吗	体验金咨询
注册有送吗	体验金咨询
注册号手机收不到验证码怎么办	体验金咨询
你好申请体验金	体验金咨询
注册送彩金吗	体验金咨询
注册彩金没有	体验金咨询
收到邮件注册送彩金啊	体验金咨询
你们平台注册送彩金18	体验金咨询
你好，注册会员有彩金送吗？	体验金咨询
申请体验金	体验金咨询
是不是注册就送18元体验金	体验金咨询
邮件特邀注册18彩金怎么	体验金咨询
注册彩金	体验金咨询
我收到邮件，注册送38	体验金咨询
你好，我申请注册彩金	体验金咨询
注册领128怎么领	体验金咨询
你们给我发的邮件注册给68怎么申请	体验金咨询
特邀特邀注册送36-88彩金	体验金咨询
注册的奖金呢	体验金咨询
申请体验金	体验金咨询
邮箱特邀。送88体验金	体验金咨询
体验金最高体多少	体验金咨询
开户送彩金？	体验金咨询
申请新人注册彩金	体验金咨询
不是注册会员号送彩金	体验金咨询
下载app送彩金怎么老是等不到验证码呢？	体验金咨询
请问体验金提款需要电话核实吗	体验金咨询
注册送128怎么申请	体验金咨询
注册怎么申请彩金呢	体验金咨询
新用户是不是送12到88元彩金？	体验金咨询
你们注册送彩金	体验金咨询
你们的体验金只能玩老虎机类型的吗，可以玩体育吗	体验金咨询
你们给我发的邮件注册给彩金的	体验金咨询
注册彩金申请	体验金咨询
你好。我刚注册的，怎么送彩金	体验金咨询
新人有彩金吗	体验金咨询
注册送体验金吗	体验金咨询
不是说注册送分吗	体验金咨询
为什么说我信息重复申请体检金	体验金咨询
z注册送彩金是吗？	体验金咨询
注册送体验金是吗？	体验金咨询
注册彩金申请	体验金咨询
注册送132	体验金咨询
注册送	体验金咨询
注册送彩金	体验金咨询
注册送体验金	体验金咨询
体验金	体验金咨询
我要体验金	体验金咨询
收到邮件注册送132	体验金咨询
我申请注册彩金送123的那种	体验金咨询
新注册有奖金	体验金咨询
注册彩金	体验金咨询
注册送彩金	体验金咨询
  我注册为什么没有彩金	体验金咨询
这是我的号你帮忙看看我的注册彩金可以领吗	体验金咨询
你们的体验金能玩体育投注吗	体验金咨询
岭取注册金	体验金咨询
岭取体验金	体验金咨询
岭取注册彩金	体验金咨询
岭取注册体验金	体验金咨询
新会员有钱送？	体验金咨询
领取体验金	体验金咨询
我请问我手机收到短信注册送42彩金？是真的吗？	体验金咨询
 收到邮件，邀请注册送彩金36—88	体验金咨询
注册有送吗	体验金咨询
提示我银行卡重复	体验金咨询
申请体验金说我银行卡重复	体验金咨询
申请体验金说我卡号重复	体验金咨询
岭取注册金	体验金咨询
岭取体验金	体验金咨询
领取体验金	体验金咨询
申请体验金	体验金咨询
申请体验金提示我申请过了	体验金咨询
申请体验金说我申请过了	体验金咨询
收不到手机验证码	体验金咨询
手机验证码	体验金咨询
体验金收不到验证码	体验金咨询
手机验证码	体验金咨询
我银行卡重复	体验金咨询
体验金提示银行卡重复	体验金咨询
银行卡重复	体验金咨询
体验金收不到手机验证码	体验金咨询
注册新账号怎么领取免费彩金	体验金咨询
申请注册彩金	体验金咨询
注册就送18到88我怎么领取我想先试试	体验金咨询
以前叫我注册送的吗怎么不没有看见送	体验金咨询
注册送彩金吗？	体验金咨询
注册送彩金	体验金咨询
收到注册有送	体验金咨询
我收到你们邮箱注册送88是吗	体验金咨询
你好我收到你们的邀请邮件注册送128	体验金咨询
我下载APP申请彩金怎么收不到验证码	体验金咨询
.体验金怎么没送？	体验金咨询
注册奖金好久到帐哟？	体验金咨询
注册彩金呢?	体验金咨询
领取132体验金	体验金咨询
我收到邀请注册就送88彩金	体验金咨询
杂个收不到验证码	体验金咨询
注册一个帐号送彩金	体验金咨询
收到邮件注册送18元彩金	体验金咨询
无法申请体验金，提示重复讯息	体验金咨询
我怎么没领到注册彩金	体验金咨询
新会员有钱送？	体验金咨询
特邀，注册送88	体验金咨询
领取注册彩金随机	体验金咨询
发的邮箱说注册送88怎么申请的	体验金咨询
邮箱收到信息注册可申请88元彩金	体验金咨询
申请开户体验金	体验金咨询
咋申请开户彩金了	体验金咨询
申请注册88	体验金咨询
开户体验金	体验金咨询
亲，注册送18元，怎么送呀	体验金咨询
申请开户彩金	体验金咨询
特邀注册送88	体验金咨询
注册彩金	体验金咨询
我QQ邮箱，收到信息，注册申请账号，赠送36-88元彩金	体验金咨询
可我要申请注册彩金手机号码填错了	体验金咨询
注册送彩金吗	体验金咨询
新客户体验金怎么申请啊	体验金咨询
你好我收到信息注册送132彩金。是吗	体验金咨询
注册送58彩金	体验金咨询
请问新手用户有什么彩金送？	体验金咨询
收到邮件，邀请我注册松36–88彩金，是不是真的	体验金咨询
你好、、、我是刚才注册的新会员、、、我看咱们网页上介绍说新会员注册就送免费彩金、、、请问怎么申请啊？？？谢谢	体验金咨询
你好、、、我是刚才注册的新会员、、、我看咱们网页上介绍说新会员注册就送免费彩金、、、请问怎么申请啊？？？谢谢	体验金咨询
怎么用手机验证已经收到验证码了，就是不可以填写验证码	体验金咨询
怎么没有接收到验证码	体验金咨询
我领取过体验金吗	体验金咨询
你好，我想问下申请体验金收不到手机验证码	体验金咨询
今天你们客服打电话说 我注册有送体验金	体验金咨询
注册送58	体验金咨询
注册新会员给彩金吗	体验金咨询
注册送彩金是吗	体验金咨询
不是这个手机号不能收验证码了	体验金咨询
注册有彩金吗	体验金咨询
申请开户彩金	体验金咨询
注册送体验金吗	体验金咨询
注册彩金怎么申请	体验金咨询
我收到邮件，说注册有彩金，还有收存，app领取彩金说我资料重复	体验金咨询
注册彩金还给不给	体验金咨询
不是注册就送彩金吗	体验金咨询
注册送彩金	体验金咨询
申请邮箱特邀注册彩金128	体验金咨询
收到邮件，注册送体验金	体验金咨询
你好，我申请的注册送12的彩金打到100了可以提款吗	体验金咨询
邮箱邀请注册送送18？	体验金咨询
请问我注册送体验金吗？	体验金咨询
我注册送吗？	体验金咨询
你好，请问是不是注册新送啊？要是带别的平台注册送吗？	体验金咨询
你好，我要申请邮箱特邀注册彩金18彩金	体验金咨询
注册彩金打到多少能退？	体验金咨询
你好，注册彩金打到多少能退？	体验金咨询
注册不是送彩金嘛	体验金咨询
注册不是送彩金嘛？	体验金咨询
怎么收不到短信验证码	体验金咨询
现在注册还送88彩金吗	体验金咨询
你好，请问不是注册就有彩金送的吗？	体验金咨询
注册送彩金吗？	体验金咨询
注册送132	体验金咨询
注册送132	体验金咨询
你们发邮件说注册送88	体验金咨询
请问注册账号送免费彩金吗	体验金咨询
你好特邀注册送88？	体验金咨询
你们给我发邮件说注册就给8	体验金咨询
你好。你们给我发邮件说注册就给88	体验金咨询
你们怎么不发手机验证码啊	体验金咨询
刚刚注册 怎样领取体验金	体验金咨询
请问我下载了APP怎么不给我体验金？提示说什么重复了？	体验金咨询
注册就送	体验金咨询
开户送58吗	体验金咨询
注册送彩金吗	体验金咨询
注册免费彩金	体验金咨询
不是说注册就送彩金吗	体验金咨询
我申请彩金要验证码	体验金咨询
注册彩金	体验金咨询
你好，注册上号了怎么没发过来彩金	体验金咨询
在哪里领取体验金132	体验金咨询
注册送彩金？	体验金咨询
注册彩金	体验金咨询
注册送分？	体验金咨询
还是没有体验金啊	体验金咨询
为什么我没有体验金	体验金咨询
我申请不了注册体验金	体验金咨询
为什么我申请不了注册彩金	体验金咨询
体验金为什么收不到验证码	体验金咨询
申注册彩金	体验金咨询
App下载领彩金收到验证码，验证码输在什么地方	体验金咨询
邮件特邀注册送彩金	体验金咨询
新用户有什么优惠	体验金咨询
发邮件说注册送88	体验金咨询
领取注册彩金88	体验金咨询
新用户不是有送吗	体验金咨询
新注册不是有送吗	体验金咨询
体验金领取怎么收不到验证码的	体验金咨询
怎么申请注册金	体验金咨询
申请下载APP注册彩金	体验金咨询
申请下载APP注册彩金	体验金咨询
不是注册送彩金的嘛	体验金咨询
收到短信注册领取30	体验金咨询
你们给我发邮箱说注册送18找客服申请	体验金咨询
你好注册是否有132元彩金送	体验金咨询
app体验金没有	体验金咨询
申请注册彩金	体验金咨询
你好怎么我刚刚注册送彩金，怎么说我多次注册，我没有呀	体验金咨询
开户送68彩金是吗	体验金咨询
你好注册是否有132元彩金送	体验金咨询
注册是否有132元彩金送	体验金咨询
你好注册是否有132元彩金送	体验金咨询
我手机收不到验证码啊？	体验金咨询
注册送58彩金吗	体验金咨询
APP下载彩金申请但我手机停机了收不到验证码	体验金咨询
注册领彩金	体验金咨询
新用户注册不是给送了么	体验金咨询
我的邮箱收到邀请，注册送88	体验金咨询
APP下载彩金申请但我手机停机了收不到验证码	体验金咨询
APP下载彩金申请但我手机停机了收不到验证码	体验金咨询
注册彩金怎么没送	体验金咨询
我申请注册彩金	体验金咨询
我申请注册会员体验金	体验金咨询
岭取注册金	体验金咨询
注册彩金呢	体验金咨询
注册送体验金	体验金咨询
你们注册送彩金吗	体验金咨询
app注册彩金申请	体验金咨询
邮箱特邀注册送88	体验金咨询
注册送132元吗？	体验金咨询
注册不是要送彩金吗	体验金咨询
我申请注册体验金	体验金咨询
注册了怎么没有彩金送	体验金咨询
app彩金申请，怎么收不到验证码	体验金咨询
是不是注册送36-88	体验金咨询
注册送彩金怎么申请	体验金咨询
你好，注册申请88	体验金咨询
注册怎么没给我送呢	体验金咨询
注册彩金	体验金咨询
这个平台注册新号送彩金吗	体验金咨询
申请注册彩金	体验金咨询
你好，申请注册彩金	体验金咨询
我是领取的是注册账号彩金	体验金咨询
怎么不能申请注册送彩金活动，提示我注册资料重复	体验金咨询
怎么不能领取注册送彩金	体验金咨询
特邀注册彩金怎么领取	体验金咨询
邮件邀请注册领彩金	体验金咨询
是不是有邮箱132体验金？	体验金咨询
申请开户彩金	体验金咨询
注册彩金怎么领	体验金咨询
微信上面客服说今天注册送132	体验金咨询
注册成功，申请彩金	体验金咨询
如何申请132体验金	体验金咨询
邮箱让领取132体验金	体验金咨询
送点体验金玩玩	体验金咨询
体验金申请	体验金咨询
申请体验金	体验金咨询
申请体验金提示我	体验金咨询
申请体验金提示银行卡重复	体验金咨询
怎么我在APP申请不了体验金呢	体验金咨询
领不起体验金	体验金咨询
收不到手机验证码	体验金咨询
申请体验金收不到验证码	体验金咨询
申请体验金	体验金咨询
收不到手机验证码	体验金咨询
注册送120彩金	体验金咨询
注册送彩金	体验金咨询
新人注册有礼金送吗！	体验金咨询
你公司不是说注册新会员有58元彩金吗	体验金咨询
不是说注册新会员成功送58彩金吗	体验金咨询
我刚注册了会员！你公司不是说注册成功有58元彩金吗？	体验金咨询
注册送38元彩金？	体验金咨询
注册有送彩金吗	体验金咨询
不是注册领取彩金26吗	体验金咨询
58元注册彩金	体验金咨询
注册彩金	体验金咨询
注册送132吗	体验金咨询
注册送彩金？	体验金咨询
注册送彩金不	体验金咨询
我申请app下载彩金时候电话号码是我前面用的号码，现在我电话号码换了收不到验证码怎么办啊？	体验金咨询
app彩金领不了老是说资料重复	体验金咨询
注册没送我	体验金咨询
要怎么把体验金转到BB里？	体验金咨询
新用户有福利吗	体验金咨询
注册彩金了	体验金咨询
开户申请体验金	体验金咨询
我刚刚注册账号领体验金怎么提示注册重付什么意思	体验金咨询
体验金有吗	体验金咨询
你好注册送彩金吗	体验金咨询
帐号注册了没有送分	体验金咨询
注册送18--88奖金的了	体验金咨询
注册送彩金	体验金咨询
我短信收到开户送42	体验金咨询
我邮箱里说注册领取132	体验金咨询
我收到特邀邮件，注册送68是什么意思	体验金咨询
注册彩金怎么申请？	体验金咨询
新注册送彩金	体验金咨询
注册送38不是么	体验金咨询
开户申请彩金	体验金咨询
帮我查看一下我可以参加新会员彩金吗	体验金咨询
请问注册送彩金吗？	体验金咨询
岭取注册金	体验金咨询
新注册用户怎么领体验金？	体验金咨询
注册送彩金	体验金咨询
注册玩了怎么领彩金	体验金咨询
注册送18彩金	体验金咨询
是不是注册就送	体验金咨询
申请体验金收不到手机验证码怎么办	体验金咨询
注册不是送彩金吗	体验金咨询
不能领取体验金	体验金咨询
申请会员是否送88元吗？	体验金咨询
怎么申请注册送88	体验金咨询
app彩金是注册彩金吗	体验金咨询
注册送88彩金？	体验金咨询
我是新注册账号怎么没有收到彩金	体验金咨询
你们邀请我注册有58彩金	体验金咨询
新用户注册没有彩金吗？	体验金咨询
注册彩金	体验金咨询
不是注册会号就有彩金送吗	体验金咨询
注册奖金怎么还没有到账哟？	体验金咨询
领注册彩金	体验金咨询
新用户注册可以领彩金吗	体验金咨询
怎么没有注册彩金	体验金咨询
AGPTBBIN优惠全面升级【注册领最高88元体验金红包】村300鎹300专属链接zunbao891.com	体验金咨询
注册彩金接不到验证码呀	体验金咨询
注册账号怎么送彩金	体验金咨询
注册账号送彩金	体验金咨询
申请体验金	体验金咨询
注册送彩金吗？	体验金咨询
注册送体验金？	体验金咨询
你好不是注册送彩金吗？	体验金咨询
申请注册彩金	体验金咨询
邮箱特邀注册送38_88	体验金咨询
我体验金是不是就不能申请了？	体验金咨询
新用户注册不是送彩金么	体验金咨询
新会员注册怎么送体验金	体验金咨询
下载咨询重复是什么意思	体验金咨询
注册彩金领取，邮箱邀请的	体验金咨询
注册送彩金怎么领取	体验金咨询
注册不是送18吗	体验金咨询
注册资讯重复什么意思	体验金咨询
收到邮件注册送	体验金咨询
为什么说我的银行卡重复	体验金咨询
注册赠送88元对吗？	体验金咨询
注册彩金申请	体验金咨询
可以申请注册彩金吧	体验金咨询
申请体验金时输入不了银行卡号绑定不了银行卡	体验金咨询
收到信息注册送彩金	体验金咨询
注册怎么没有彩金派送	体验金咨询
申请体验金	体验金咨询
申请体验金我银行卡重复	体验金咨询
注册是否有彩金送	体验金咨询
注册彩金申请	体验金咨询
你好。我邮箱收到注册送彩金活动怎么领取	体验金咨询
怎么没给我开户彩金呢	体验金咨询
你好我新注册的账号什么时候给彩金啊	体验金咨询
申请注册彩金	体验金咨询
c注册彩金怎么领取	体验金咨询
怎么注册彩金申请不到	体验金咨询
申请体验金	体验金咨询
申请体验金	体验金咨询
我想问下，你家这个下载APP这个验证码怎么收不到	体验金咨询
怎么收不到验证码	体验金咨询
领彩金收不到验证码	体验金咨询
接邮件邀请注册领取88元彩金	体验金咨询
注册就送体验金妈	体验金咨询
申请注册送66？	体验金咨询
你好注册送彩金88怎么申请呢	体验金咨询
你家这个下载APP的验证码一天都收不到怎么搞	体验金咨询
体验金可以提款吗	体验金咨询
你好注册是否有132元彩金送	体验金咨询
体验金在哪领	体验金咨询
领体验金	体验金咨询
领取体验金出现系统繁忙的提示	体验金咨询
我刚才的提款怎么还没有到呢？	提款相关问题
我刚才的提款 180 还没有到	提款相关问题
提款审核怎么这么久呀	提款相关问题
麻烦等下给我出款，等那么久了，都困死啦	提款相关问题
我提款怎么还没到账	提款相关问题
第一次提款要不要电话审核	提款相关问题
最低可以提款多少	提款相关问题
我说最低提款可以提多少	提款相关问题
提款问题	提款相关问题
请问我刚提100块钱怎么这么没提出来呀	提款相关问题
申请取款	提款相关问题
咋提不现	提款相关问题
提款怎么还没到	提款相关问题
提款没有到账	提款相关问题
我的提款怎么还没到账？	提款相关问题
提款没到账	提款相关问题
提款卡号错误	提款相关问题
提款流水倍数	提款相关问题
提款未到帐	提款相关问题
提款卡号错误	提款相关问题
提款卡号	提款相关问题
怎么我的提款被取消了	提款相关问题
提现卡号错误怎么办	提款相关问题
提现卡号错误	提款相关问题
我的提现卡错误，怎么办	提款相关问题
我提款300怎么还没到账啊	提款相关问题
提款还没到账	提款相关问题
请问是不是消费一倍流水才能提现	提款相关问题
我的提款怎么还在审核？	提款相关问题
怎么还不下款呢	提款相关问题
您好 请问第一次在你们平台提款需要多久时间到账	提款相关问题
现在出款怎么这么慢	提款相关问题
提款审核需要多久	提款相关问题
取款360到帐330怎么回事	提款相关问题
取款金额不对	提款相关问题
我提现卡号写错了	提款相关问题
提款需要整数，转帐也需要整药，请问怎么提款？	提款相关问题
提款需要整数，但我帐户有0.75的小数余额，怎么提款？	提款相关问题
提款怎么提？？？整+数？？？	提款相关问题
为什么我的提款一直是待审核	提款相关问题
提款卡号错误怎么办	提款相关问题
你们网站提款需要整数，转帐也需要整数，那我的帐户里有0.49元的余额，那就是我永远不能提款了？？？	提款相关问题
查下我的提款怎么还没到账。	提款相关问题
提款还没到账啊	提款相关问题
提款怎么这么慢	提款相关问题
为什么我的提款取消了？	提款相关问题
提款卡号错误	提款相关问题
提款卡号错了	提款相关问题
提款绑错卡号	提款相关问题
提现卡号错了	提款相关问题
提现卡号绑错了	提款相关问题
提现卡号错误怎么办	提款相关问题
提款卡号错了怎么办	提款相关问题
我提款，，怎么一直待审核？？	提款相关问题
我的取款为什么取消了呀	提款相关问题
提款没到账	提款相关问题
我提款怎么没有反应呢？	提款相关问题
今天出款怎么那么慢，都十多分钟了，还没出款。	提款相关问题
我刚才取款没到账	提款相关问题
取款没到账	提款相关问题
我提款怎么还没有到账	提款相关问题
提款金额不得超过最大提款的额度。 这个是什么意思	提款相关问题
出款问题	提款相关问题
提款要多久审核	提款相关问题
提款问题	提款相关问题
多少可以出款	提款相关问题
我要提款不给	提款相关问题
我想问下我提款显示成功了，怎么钱还没提出来	提款相关问题
你好我想知道我提款显示成功可钱还在游戏账户里	提款相关问题
提款显示成功，为什么钱还在账号里	提款相关问题
提款显示成功为什么钱提不出来	提款相关问题
提款多久到	提款相关问题
取款未到账	提款相关问题
我昨天提款为什么取消了呀	提款相关问题
你好，账户出款，半个小时了还没打款。怎么搞的	提款相关问题
提款的卡号打次错了	提款相关问题
提款审核	提款相关问题
为什么取消我的提款	提款相关问题
提款取消	提款相关问题
提款没到	提款相关问题
我要提款	提款相关问题
提款卡号错	提款相关问题
我的提款怎么还没有审核啊	提款相关问题
你好，出款一直没审核	提款相关问题
我的提现都好半天了。	提款相关问题
存款100是需要多少才可以提现	提款相关问题
我那个提款怎么一直在审核呢？	提款相关问题
怎么没取消我的提款吗	提款相关问题
别的提款秒到帐的	提款相关问题
我提款啊	提款相关问题
提款没上帐	提款相关问题
快帮我处理我的提款吧	提款相关问题
可以提现吗	提款相关问题
可以提现金吗	提款相关问题
提款多长时间到账	提款相关问题
有没有帮我查询一下我提款	提款相关问题
提款也没处理好	提款相关问题
怎么取款没到	提款相关问题
怎么提款啊	提款相关问题
多少可以提款了	提款相关问题
怎么我上午提的钱，下午也没到账，老是正在审核。	提款相关问题
审核提款这么慢？	提款相关问题
审核提款咋这么慢	提款相关问题
取款密码就是登陆密码吗？	提款相关问题
会员账号mqh1983申请出款为什么一直待审核状态，需要多久可以给我处理出款	提款相关问题
提现没到账呀	提款相关问题
提款怎么还没到账？	提款相关问题
怎么取款	提款相关问题
怎么提款还没审核？	提款相关问题
提款没有到账	提款相关问题
我申请了提款 什么时候能够到账	提款相关问题
提款没有到账	提款相关问题
提款没反应	提款相关问题
提款好久了还没到账	提款相关问题
提款一直显示审核中	提款相关问题
提款提错卡了	提款相关问题
提款键无法点击	提款相关问题
我的提现都申请半天了	提款相关问题
怎么我提款这么久还不到账	提款相关问题
我怎么没有发把老虎机里面的钱提现	提款相关问题
这么久还在待审核	提款相关问题
我的提款什么时间能到账	提款相关问题
我的提款不到账	提款相关问题
我的提款到现在也没到账	提款相关问题
提款怎么到现在不到账	提款相关问题
提款多长时间到账	提款相关问题
请问我的出款多久到账呢	提款相关问题
我还刚刚提款的钱，已经执行到帐了，可是卡里没有钱	提款相关问题
我申请出款	提款相关问题
为什么的提款的还没审核？	提款相关问题
我的提款怎么还到账	提款相关问题
提款怎么取消了	提款相关问题
提款为啥取消	提款相关问题
如何提款	提款相关问题
如何提款	提款相关问题
我提款了。怎么还没有到账？	提款相关问题
你好我的取款怎么还没有到	提款相关问题
工商银行支持出款吗	提款相关问题
最低提款几倍流水	提款相关问题
你们家提款审核怎么这么慢	提款相关问题
可以出款了	提款相关问题
我提款怎么没有反应	提款相关问题
提款审核催一下	提款相关问题
我怎么提不了款	提款相关问题
我的提款怎么一直不审核	提款相关问题
帮我取消提款。谢谢。	提款相关问题
我地提款怎么还没有到账	提款相关问题
提款没到账	提款相关问题
可以提现吗	提款相关问题
为什么把我的取款取消了？	提款相关问题
提款怎么还不到账啊,!?	提款相关问题
为什么提款时显示登录密码错误	提款相关问题
提款显示登录密码错误	提款相关问题
怎么搞到提现还没有通过呢	提款相关问题
为啥我的提款给我取消了	提款相关问题
怎么搞到提现还没有到账呢	提款相关问题
九安钱包什么时候可以提款	提款相关问题
取款为什么还没有到账呢	提款相关问题
你好，麻烦帮我看一下我的提现怎么没有到账	提款相关问题
提款没有到账	提款相关问题
我在提款怎么没有通过	提款相关问题
我的提款怎么还没到	提款相关问题
客服提现审核要多久	提款相关问题
刚提款一百怎么这就还到账呀	提款相关问题
每天鉴到达到多少金额才可以提现.	提款相关问题
我为什么不能取款呢？我又没有优惠，第一次玩	提款相关问题
你好九安钱包什么时候可以提款	提款相关问题
提款没到账	提款相关问题
我要提款帮我刷新下DT流水	刷新流水
不能从PT转账出来一直说我差流水....	刷新流水
帮我刷新一下PT转主账户转账说流水不够早就够了啊？	刷新流水
转不了呢，说我流水不够	刷新流水
帮我刷新流水	刷新流水
一开始不是说只要160流水就能提现啦吗？现在还要多少	刷新流水
帮我刷新pt投注流水，户内转账	刷新流水
帮我涮新PT的流水	刷新流水
帮我看下投注额啊，按理到了就是不刷新，取不了钱	刷新流水
帮我更新下DT投注，我要转账	刷新流水
我的流水已经300多了怎么还无法转账	刷新流水
转账麻烦刷新一下流水pt	刷新流水
我打了多少流水	刷新流水
请请问我户内转账差多少流水	刷新流水
请问，在哪里查流水？	刷新流水
帮我刷新pt流水	刷新流水
你好，请帮忙更新一下流水。	刷新流水
更新pt流水。转账	刷新流水
帮我刷新pt流水	刷新流水
能帮我查询一下流水嘛	刷新流水
请问可以帮我查看一下我的流水嘛	刷新流水
请帮我刷新下流水，pt	刷新流水
老虎机流水不对	刷新流水
更新一下流水啊	刷新流水
提款要打多少流水	刷新流水
为什么打了一天，，流水还不够	刷新流水
请帮我刷新下流水	刷新流水
查询流水	刷新流水
查流水	刷新流水
帮我更新流水	刷新流水
查询一下我的优惠流水有多少了差多少	刷新流水
我流水到了DT平台不能转主账户？	刷新流水
我还差多少流水可以出款	刷新流水
帮我刷新下流水	刷新流水
帮我查一下有效投注	刷新流水
更新PT流水	刷新流水
刷新打码量	刷新流水
我的总流水	刷新流水
请帮我查一下流水	刷新流水
更新流水	刷新流水
我玩了好几个小时流水不变	刷新流水
你好我的流水怎么下注都不涨了，款转不了了	刷新流水
给我发邮件，存款100赠送100，	首存咨询
那个送百分百彩金的活动能玩真人视讯吗	首存咨询
首存100% 可以打PT古怪猴子吗	首存咨询
首存100% 可不可以打电子MG的 舞龙	首存咨询
你好,存100送100,百家乐也可以吗	首存咨询
存100送100	首存咨询
首存有什么优惠活动？	首存咨询
你好问下现在首存有什么优惠吗	首存咨询
我如果参加首存优惠转账到MG后是不是不能再转账到PT了？	首存咨询
我可以申请pt首存吗	首存咨询
麻烦查询我可以申请首存%100优惠吗？	首存咨询
帮我查查看我的账号申请首存过了没	首存咨询
不是充一百送一百吗？	首存咨询
在哪里申请首存10元送28元	首存咨询
首存10送28吗？	首存咨询
我要首存	首存咨询
首存会员金	首存咨询
现在首存存十送二十吗？	首存咨询
我第一次在这个平台玩	首存咨询
首存优惠	首存咨询
首存送优惠	首存咨询
首存优惠活动怎么办	首存咨询
怎么申请首存	首存咨询
怎么申请首存？	首存咨询
不是首次充100送100吗	首存咨询
存100送100的优惠可以玩什么？	首存咨询
存送优惠 首存128是什么意思？	首存咨询
首存优惠最低多少可以申请	首存咨询
老虎机首存128%	首存咨询
那个老虎机首存128我可以申请不	首存咨询
新注册是不是有首存百分百优惠	首存咨询
为啥我不能首存优惠	首存咨询
如何申请首存	首存咨询
首次存款不送彩金吗	首存咨询
首次充值有什么优惠吗	首存咨询
申请首存彩金100%	首存咨询
有首存活动吗	首存咨询
怎么我申请不到首存优惠呢	首存咨询
我怎么不能自助首存优惠	首存咨询
申请不了首存优惠	首存咨询
我怎么不能申请首存优惠	首存咨询
这个首存送100% 的优惠mg电子里面那些游戏不可以玩	首存咨询
首存流水多少	首存咨询
怎么绑定银行卡	密保银行卡解绑
我的卡号错误	密保银行卡解绑
卡号绑错了	密保银行卡解绑
给我银行卡解绑！	密保银行卡解绑
卡号错了怎么办	密保银行卡解绑
我怎么帮不了卡	密保银行卡解绑
我绑不了卡	密保银行卡解绑
你好，怎么绑定银行卡？	密保银行卡解绑
把我银行卡给解绑了呗，	密保银行卡解绑
银行卡错误	密保银行卡解绑
卡号错误	密保银行卡解绑
如何绑定银行卡	密保银行卡解绑
我要解绑银行卡	密保银行卡解绑
我要查询银行卡十二位卡号数字	密保银行卡解绑
我要查询12位卡号	密保银行卡解绑
我的银行卡全部信息	密保银行卡解绑
帮我查询一下我的农业银行卡号信息，我卡丢了，我要存钱动银行才能充钱到游戏。	密保银行卡解绑
能不能帮我查询一下我的农业银行卡号？	密保银行卡解绑
绑定不了卡号无法打	密保银行卡解绑
提示说我的卡号己绑定过	密保银行卡解绑
提示我卡号绑定不成功什么意思	密保银行卡解绑
你查一下我的卡号为什么绑定不了	密保银行卡解绑
银行卡绑定不了，显示银行卡号不存在	密保银行卡解绑
显示银行卡不存在	密保银行卡解绑
为什么绑定不了银行卡	密保银行卡解绑
我怎么绑不了卡啊	密保银行卡解绑
帮我解除我在你平台绑定的姓名和银行卡号。	密保银行卡解绑
我是要解除绑定。	密保银行卡解绑
申请救援金	救援金咨询
救援金什么时候发送	救援金咨询
救援金需要多少倍流水才能提款？	救援金咨询
怎么没有救援金	救援金咨询
你好，自助救援金什么时候发	救援金咨询
申请救援金	救援金咨询
我怎么不能领取救援金了？	救援金咨询
救援金什么时候发放？	救援金咨询
今天的救援金怎么还没发？？？	救援金咨询
请问一下这个救援金什么时候领取	救援金咨询
救援金	救援金咨询
我就领了十多块钱的救援金，为啥要两千多投注额？	救援金咨询
为什么没有救援金	救援金咨询
救援金啥时候反啊	救援金咨询
我咋申请不到救援金是	救援金咨询
申请救援彩金	救援金咨询
申请救援金会员	救援金咨询
今天的救援金好久才到账	救援金咨询
我申请救援金为什么申请不了	救援金咨询
我申请的救援金为什么没有呢	救援金咨询
申请救援金	救援金咨询
帮我申请个转运金，这几天老是输钱了，	红包咨询
电话通知我有红包送我	红包咨询
红包优惠代码是多少	红包咨询
申请转运包	红包咨询
收到手机短信送8-588的红包…在哪里领呢？	红包咨询
邮箱特邀	红包咨询
红包卷没用过怎么就使用了	红包咨询
申请转运红包	红包咨询
亲，我收到邮件激活账户并输入红包代码可以领取红包！怎么不可以呢？	红包咨询
特邀送彩金	红包咨询
您好请问送的18元红包优惠券需要多少流水可以提款	红包咨询
新注册不是有活跃度红包吗	红包咨询
新注册有活跃度红包吗	红包咨询
新注册活跃度红包呢	红包咨询
新注册活跃度红包	红包咨询
有转运红包吗？	红包咨询
红包代码帮我激活一下。	红包咨询
申请一个转运红包！这么长时间了都不出分	红包咨询
帮忙核实一下红包吧 还没到。	红包咨询
优惠代码未审核	红包咨询
红包优惠代码未审核叫我联系客服处理	红包咨询
送的红包在哪呢	红包咨询
红包哪里领	红包咨询
听说你们有红包可以派发？	红包咨询
红包优惠卷	红包咨询
红包优惠券	红包咨询
存送优惠券	红包咨询
可以送红包吗	红包咨询
我看邮件上面说我被尊宝特邀我88的彩金，我需要怎么领也。	红包咨询
短信特邀132彩金	红包咨询
我的红包优惠券再发一个	红包咨询
红包优惠券	红包咨询
申请特邀送18	红包咨询
申请特邀彩金	红包咨询
红包代码未审核	红包咨询
我的红包代吗	红包咨询
我的红包代吗领不到	红包咨询
存送/红包优惠卷	红包咨询
你好！qq特邀彩金在你这领取吗？	红包咨询
Anotefrom特邀特邀恭喜你被【尊宝】特邀送彩金高至88链接：https://www.zun510.com体育/百家乐/老虎机/捕鱼随便玩,带着您的小伙伴一起来玩哦加Q1793285380	红包咨询
现在没有抢红包的优惠了吗	红包咨询
你好。刚微信客服给了我个百分百存送的优惠卷·你帮我查查是多少流水的啊？	红包咨询
邮箱特邀送88	红包咨询
存送/红包优惠卷	红包咨询
自助优惠红包代码提示代码未审核	红包咨询
优惠代码未审核	红包咨询
我要红包	红包咨询
你好l领取特邀彩金	红包咨询
在那里领红包呢	红包咨询
特邀送132到哪申请啊	红包咨询
申请转运包	红包咨询
给我申请转运包	红包咨询
申请一个转运红包嘛xddw880208	红包咨询
申请转运彩金	红包咨询
优惠卷怎么未审核呀	红包咨询
我要红包	红包咨询
红包优惠券	红包咨询
申请红包卷	红包咨询
红包优惠券	红包咨询
我要红包	红包咨询
我要红包	红包咨询
有邀请邮件找谁领彩金	红包咨询
邀请领彩金？	红包咨询
你好，我领取填写优惠红包	红包咨询
邮箱收到特邀36-88彩金	红包咨询
申请红包优惠券代码	红包咨询
申请转运红包	红包咨询
#####特邀先领132无流水达到388就可提【https://zunbao124.com/】	红包咨询
为什么之前有时候有红包，现在又没有红包。？	红包咨询
邮箱特邀彩金，	红包咨询
申请一个转运红包	红包咨询
邮箱特邀	红包咨询
请问怎么领红包啊	红包咨询
干嘛一直在邮箱邀请我，又不送彩金？	红包咨询
在哪里领取红包	红包咨询
申请132特邀彩金	红包咨询
申请特邀88	红包咨询
申请88特邀彩金	红包咨询
不是说注册有红包送吗？	红包咨询
有没有红包优惠券？	红包咨询
申请18元邮箱邀请彩金	红包咨询
能不能申请红包。	红包咨询
恭喜你被【尊宝】特邀送彩金高至88链接：https://www.zun510.com体育/百家乐/老虎机/捕鱼随便玩,带着您的小伙伴一起来玩哦加Q1793285380	红包咨询
给个红包好吗	红包咨询
能不能给个红包	红包咨询
我有没有优惠券可以领取？	红包咨询
收到邀请送88	红包咨询
邮箱特邀彩金18申请	红包咨询
申请邮箱特邀88	红包咨询
你好我在邮箱收到特邀信	红包咨询
激活红包代码	红包咨询
红包优惠卷我兑换了怎么没有？、	红包咨询
你们给我发邮箱说特邀彩金18找客服申请	红包咨询
存款200送5个红包真的假的	红包咨询
为什么我的号没有红包优惠劵	红包咨询
申请转运红包刚才掉线了	红包咨询
我朋友的号都有送转运红包，现金券什么的为什么我的号没有	红包咨询
申请邮箱特邀彩金88	红包咨询
微信客服发给我的红包代码到底是什么红包哦	红包咨询
微信客服给我的红包代码，我复制上去他怎么说代码没审核呢	红包咨询
激活红包代码	红包咨询
申请转运红包	红包咨询
我没有领取红包优惠券怎么就没有了啦	红包咨询
怎么申请红包优惠券代码	红包咨询
红包优惠券	红包咨询
电话特邀领取红利	红包咨询
申请邮箱邀请彩金	红包咨询
邮箱特邀	红包咨询
你好，红包优惠卷有游戏限制吗	红包咨询
是不i是有特邀彩金	红包咨询
QQ邮箱特邀送128	红包咨询
收到邮箱特邀请问是不是送38彩金	红包咨询
我是特邀，赠送给我的优惠券你们还没审核	红包咨询
是你们的优惠券还没审核，我莫法用	红包咨询
优惠券没办法用	红包咨询
声请一个转运红包嘛	红包咨询
申请邮件特邀18彩金	红包咨询
红包代码激活问题	红包咨询
微信客服给我发的1321440uxyhj180810jbjthjva3km35已经使用了怎么办	红包咨询
优惠券未审核哦	红包咨询
红包优惠券	红包咨询
红包优惠券在哪用	红包咨询
我要怎么拿到红包优惠券	红包咨询
我站内信里的红包优惠券怎么都用过了	红包咨询
红包优惠券	红包咨询
优惠代码未审核什么意思	红包咨询
是特邀体验jin	红包咨询
邮箱特邀	红包咨询
短信收到回馈特邀	红包咨询
申请转运红包	红包咨询
系统给我发的红包优惠券，我没有使用过，怎么显示的我已经使用？	红包咨询
我有个红包优惠卷过期了怎么办	红包咨询
你好，我是微信特邀注册你们平台得，说是注册送58.。就立马给我了红包优惠券。我就注册了，客服妹妹说喊我激活一下账号活跃度才能领取58彩金得。我也存款活跃了。可是。。你们客服妹妹说立马帮我激活红包优惠卷，一直等到现在都没有激活	红包咨询
我收到你们的特邀	红包咨询
领取特邀68	红包咨询
领取特邀68	红包咨询
申请转运彩金	红包咨询
转运红包	红包咨询
申请特邀88	红包咨询
邮箱特邀	红包咨询
收到电子邮件特邀送彩金	红包咨询
申请转运金	红包咨询
转运红包	红包咨询
申请转运红包	红包咨询
申请个红包玩一下！	红包咨询
昨天輸了一千請給我申請一個轉運紅包	红包咨询
申請紅包	红包咨询
轉運紅包	红包咨询
申請轉運紅包	红包咨询
申请邮箱特邀88	红包咨询
红包优惠代码提交了要多久才到	红包咨询
申请转运红包	红包咨询
申请转运红包	红包咨询
红包优惠券需几倍流水才能转账	红包咨询
申请特邀88	红包咨询
我想问下这个填卷红包在哪里领	红包咨询
摇色子优惠券发放了吗	红包咨询
请问我的优惠红包卷怎么不能使用	红包咨询
红包存送卷怎么领	红包咨询
邀请好友	好友推荐
我介绍朋友玩游戏	好友推荐
我朋友推荐你们网站，注册你们网站给不给彩金	好友推荐
邀请个朋友进来玩怎么弄	好友推荐
有没有推荐好朋奖金	好友推荐
我要把你们网站推荐我们朋友，怎么推荐	好友推荐
朋友推荐你们网站，新注册会员给不给彩金	好友推荐
好友有送吗	好友推荐
你好，你们客服微信告诉我下呗？	官网及账号问题
你们招代理不?	官网及账号问题
代理专员	官网及账号问题
小哥哥、小姐姐、您好，我是乐盈策略论坛广告专员,，黄金发财位置出售，抓紧时机，优惠多多，等待老板您的加入!我站网址：996.vcQQ：2913149876skype：leyingcelue6789@outlook.com	官网及账号问题
qq客服的qq号是多少？	官网及账号问题
我要如何截图	官网及账号问题
您好，我们是第4方支付平台，我们现在有稳定的网银支付宝微信银联通道，成功率高，下发方式D0.我的联系方式Q：22482508请问贵公司有需要相关支付通道吗？	官网及账号问题
让我的专属客户联系我	官网及账号问题
注册不了	官网及账号问题
我专属客服	官网及账号问题
解除禁言	官网及账号问题
我要人工专属客服	官网及账号问题
要怎么截图啊	官网及账号问题
怎么截图啊	官网及账号问题
我不会截图阿	官网及账号问题
我不会发截图	官网及账号问题
告诉我怎么发截图阿	官网及账号问题
截图怎么发啊	官网及账号问题
怎么发截图阿	官网及账号问题
截图好了怎么发	官网及账号问题
我注册没有邮箱可以注册吗？	官网及账号问题
我怎么注册不了	官网及账号问题
我是谷歌，注册总是说密码有问题	官网及账号问题
我是博彩在线推广，方便给个你们广告负责人的QQ吗？	官网及账号问题
qq客服是多少	官网及账号问题
QQ客服qq号多少	官网及账号问题
怎么查寻自己什么时候注册日期	官网及账号问题
怎么截图	官网及账号问题
您好，我这边是做百度推广的。百度游戏资质可上电玩/棋牌/捕鱼等休闲游戏。百度平台捕鱼电玩（晚七早八也可全天）棋牌（全天）	官网及账号问题
qq客服	官网及账号问题
qq克服号	官网及账号问题
您好，我们这边是做广告代发的~您这边需要推广吗？	官网及账号问题
无法注册	官网及账号问题
怎么截图	官网及账号问题
我想要截图	官网及账号问题
如何截图	官网及账号问题
怎么截图	官网及账号问题
我不能截图	官网及账号问题
我要如何截图	官网及账号问题
我不能截图	官网及账号问题
我怎么截图	官网及账号问题
专属客服	官网及账号问题
我有微信专属客户吗？	官网及账号问题
加微信客户	官网及账号问题
我账号是什么时候注册的	官网及账号问题
你们招商的QQ多少	官网及账号问题
微信客服	官网及账号问题
就是让我加微信我加不上	官网及账号问题
高防CDN防护，域名加速，隐藏真实IP保护源服务器安全，可以防御一切域名带来的DDOSCC，有无备案均可使用，24小时在线技术，第一时间响应并处理问题，。本公司提供高防CDN防护，域名加速，隐藏真实IP保护源服务器安全，可以防御一切域名带来的DDOSCC，有无备案均可使用，24小时在线技术，第一时间相应并处理问题，有需要随时联系我测试，满意效果后付款。QQ：2222123986	官网及账号问题
您好，请问贵公司需要推广宣传吗？	官网及账号问题
我就是谷歌的	官网及账号问题
你好注册怎么注册不了？	官网及账号问题
你好找一下负责我的专员	官网及账号问题
微信客服账号多少	官网及账号问题
帮我查询一下，什么时候注册的	官网及账号问题
我的手机无法将此截图转发咋办？你昨晚是怎样帮忙解决的呢？	官网及账号问题
我没用过截图所以问你怎么发过来	官网及账号问题
发不了截图	官网及账号问题
发不了截图啊	官网及账号问题
承接BCPC菠菜劫持量电子六合真人体育SSC寻找有实力的大平台长期合作。可免费测试一个小时有意向联系QQ2571538585	官网及账号问题
你好 可以给你们线下代理微信给我吗 我申请线下活动	官网及账号问题
我是做推广的	官网及账号问题
您好，有需要第三方支付请联系我（微信扫码支付宝H5，QQ,银联，网银....成功率90%以上D0结算，秒到）平台稳定，资金安全，抗投诉，稳定接口长期合作需要联系QQ:657461904	官网及账号问题
怎么邮箱老是格式不对，注册不了	官网及账号问题
您好，我们这边是支付通道这一块的，包括微信，支付宝，网银等，有需要	官网及账号问题
我刚刚注册的账号密码错误了	官网及账号问题
我注册账号怎么说我注册过	官网及账号问题
注册帐号在网站上吗？还是下载APP再注册呀	官网及账号问题
你们微信客服下班了吗？	官网及账号问题
我的专属客服	官网及账号问题
您好，我想加盟代理	官网及账号问题
怎么发图喔	官网及账号问题
我想重新注册了	官网及账号问题
我想重新注册	官网及账号问题
说网：说网：book.av000888.com图片网图片网：片网：www.av000888.com电影网电影网：影网：av000888.com复制粘复制粘贴浏览器打开微信号AZ157520您说：14:02:56我们团队网站招租您说：14:03:18每天访问量2000以上您说：14:04:22希望给你们公司带来更好的效益	官网及账号问题
您好！我这边是巨安支付，有支付宝.微信.网银等支付通道，您这边有需要支付通到吗？	官网及账号问题
本站分别为小说、图片、电影三个站。日访问独立访客千数以上。三个网站以以最低价2000元，请问是否需要投放？	官网及账号问题
手机号显示存在	官网及账号问题
重新可是显示我已经注册过了啊	官网及账号问题
你就是专属客服	官网及账号问题
你是代理还是客服呢	官网及账号问题
你好，邮箱qq不能注册	官网及账号问题
qq邮箱不能注册邮箱	官网及账号问题
qq邮箱格式？	官网及账号问题
注册金呢？	官网及账号问题
我注册过吗	官网及账号问题
您好，请问贵公司需要广告代发吗？	官网及账号问题
1.支付宝推广2.苹果iMessage推信/米推3.视频分享/微信裂变4.短信卡发5.微博推广6.24小时暴力私聊口碑宣传7.邮件群发8.微信定位投放9.微信群推广10.抖音push有需要请联系我司推广部联系QQ：3600878680VX：dogge0728	官网及账号问题
昨天为什么没有派发代理佣金	官网及账号问题
代理今天上班么	官网及账号问题
您好，有需要第三方支付请联系我（微信扫码支付宝H5，QQ,银联，网银....成功率90%以上D0结算，秒到）平台稳定，资金安全，抗投诉，稳定接口长期合作需要联系QQ:657461904	官网及账号问题
专属客服	官网及账号问题
你好请问贵公司支付接口偶有需要吗	官网及账号问题
依附于费推广	官网及账号问题
你好，我的代理账号密码忘了，能帮我查一下么	官网及账号问题
专属客服是谁	官网及账号问题
不能发截图了？	官网及账号问题
发不了截图	官网及账号问题
昨天怎么没有派发代理佣金	官网及账号问题
代理星期天上班么？	官网及账号问题
邮箱格式错误	官网及账号问题
提示我邮箱格式错误	官网及账号问题
为什么提示我邮箱格式错误	官网及账号问题
邮箱格式是什么	官网及账号问题
什么邮箱格式	官网及账号问题
注册说邮箱格式错误	官网及账号问题
我有注册过帐号吗	官网及账号问题
我有注册过吗	官网及账号问题
我之前注册过帐号吗	官网及账号问题
我有帐号吗	官网及账号问题
我有账号吗	官网及账号问题
我之前注册过账号吗	官网及账号问题
我有注册过账号吗	官网及账号问题
我注册过吗	官网及账号问题
帮我查我注册过吗	官网及账号问题
帮我查查我有账号吗	官网及账号问题
帮我查查我有帐号吗	官网及账号问题
没投注记录没有反水喃	返水咨询
为什么我pt没有反水可以领呢	返水咨询
我的为什么洗不出自助洗码	返水咨询
帮我把PT反水刷新一下	返水咨询
自助洗码	返水咨询
刷新自助反水	返水咨询
Pt有投注没洗码	返水咨询
刷新自助反水	返水咨询
麻烦刷新一下自助反水	返水咨询
自助反水为啥不更新	返水咨询
AG真人反水，几点返	返水咨询
BBIN反水不知道在哪里查看	返水咨询
BBIN有没有反水	返水咨询
反水怎么没有	返水咨询
为啥pt自助洗吗不可以领	返水咨询
什么情况我领取不了我PT的反水？	返水咨询
你好棋牌游戏有反水吗	返水咨询
给我查一下我的返水金	返水咨询
没办法洗码	返水咨询
开元棋牌没反水？	返水咨询
自助返水	返水咨询
反水现在能不能申请	返水咨询
没领到系统反水	返水咨询
我想自助反水	返水咨询
我微信充200才到191？	存款相关问题
你好我的存款没有到账	存款相关问题
我刚用微信扫码100没道	存款相关问题
你好刚支付宝转一百没到帐能帮我查一下吗	存款相关问题
存了款没到账	存款相关问题
不好意思我刚才支付宝转账好像没交订单就直接交了	存款相关问题
通过支付宝存款100没到账	存款相关问题
存款微信和QQ都用不了呀	存款相关问题
我建设银行现在支付宝转账充值到工商银行要到7点？？	存款相关问题
我用支付宝入款100元怎么没到帐？	存款相关问题
用支付宝入款未到帐	存款相关问题
存款没到	存款相关问题
我刚用微信入款100怎么没有到帐？	存款相关问题
，我怎么被限额了	存款相关问题
不能存款	存款相关问题
如何存款	存款相关问题
你们这个存钱哪里存	存款相关问题
存款没到账，支付宝	存款相关问题
存款没有到账	存款相关问题
为什么微信被限额了	存款相关问题
为什么会提示说我活跃度不足	存款相关问题
我要取消订单	存款相关问题
怎么存款啊?	存款相关问题
最低存款	存款相关问题
支付宝存款没到账	存款相关问题
存款页面是空白	存款相关问题
最低存款金额是多少	存款相关问题
存款怎么没有到账	存款相关问题
我怎么到不到充值入口啊	存款相关问题
怎么微信充值用不起了	存款相关问题
平台支付宝可以充值吗	存款相关问题
刚才冲了500 没有到账	存款相关问题
你们公司的人是有病吗？搞的我把钱转到微信里现在微信冲值窗口又没了，好玩是吧	存款相关问题
存了500 没有倒帐	存款相关问题
不能用点卡存款了？	存款相关问题
支付宝存款没到账	存款相关问题
我刚充值了，为什么没有啊	存款相关问题
我游戏充值了一百怎么剩50了	存款相关问题
我游戏充值的钱去哪了？	存款相关问题
存款未到账，支付宝	存款相关问题
支付宝转账提示到了：还没上分	存款相关问题
最低存多少	存款相关问题
最低存款	存款相关问题
微信现在从值不了	存款相关问题
你好，支付宝转账不是实时到账吗	存款相关问题
刚刚充值没有到账	存款相关问题
我存款没有到账	存款相关问题
我存款成功了但没有到账	存款相关问题
我微信存款成功但没有到账	存款相关问题
我刚刚支付宝存款怎么还没到账	存款相关问题
在哪里充值？	存款相关问题
充值不到账	存款相关问题
我存款100，到账99.96，申请不了存送啊	存款相关问题
支付宝存款没到账	存款相关问题
存款没到帐	存款相关问题
支付宝扫码没到账	存款相关问题
存款没到	存款相关问题
是不是存款有送？	存款相关问题
我微信支付一百怎么没到	存款相关问题
我存款成功为到账	存款相关问题
存款没到账	存款相关问题
刚存了200 怎么没有到账	存款相关问题
支付宝存款未到账	存款相关问题
最低存款金额限制	存款相关问题
最低存多少	存款相关问题
存款没有到账	存款相关问题
手续费	存款相关问题
存款没到	存款相关问题
最低存多少	存款相关问题
最低存款	存款相关问题
我刚刚存款10元为什么不到账	存款相关问题
存款没有到账	存款相关问题
支付宝存款没到账	存款相关问题
充值没有到账	存款相关问题
怎么存钱上去？	存款相关问题
存款成功钱没到	存款相关问题
支付宝已经到账，怎么账号还没有	存款相关问题
存款没到账	存款相关问题
存款不到	存款相关问题
充款半个小时了到不了账，你们这是什么意思？	存款相关问题
我刚刚充值了钱怎么还没到账	存款相关问题
我充的钱咋还没到账	存款相关问题
咋的我的存款还没到账	存款相关问题
我想存款	存款相关问题
我游戏充值了一百怎么剩50了	存款相关问题
我怎么被限额了	存款相关问题
支付宝充值成功没有到账	存款相关问题
存款掉单了在线客服界面进不去	存款相关问题
我存款掉单了	存款相关问题
我存款掉单了怎么办	存款相关问题
我存款掉单了找不到人	存款相关问题
为什么我冲了200只有196的额度	存款相关问题
我冲100只到99.96是怎么样	存款相关问题
我存100到账90怎么申请优惠啊	存款相关问题
优惠申请要100啊可是我存100只到账98	存款相关问题
存款到账怎么少了阿	存款相关问题
我的存款怎么少了啊	存款相关问题
我刚刚存款100怎么少了阿	存款相关问题
我刚刚微信转账了100元，网络断了，这么钱不到帐	存款相关问题
你好  我的充值没有到，麻烦帮我查询下	存款相关问题
存款没到账	存款相关问题
存款怎么还不到	存款相关问题
我支付宝充值没有到。	存款相关问题
存款没到账	存款相关问题
存款掉单了在线客服界面进不去	存款相关问题
存款没到  	存款相关问题
你好，充不了值嘛	存款相关问题
我刚刚有一笔存款，已经转账成功了怎么没有反映	存款相关问题
我的存款还没到账	存款相关问题
我存了300不到账	存款相关问题
我的充值没有到账	存款相关问题
我不会存款	存款相关问题
存款掉单了	存款相关问题
支付宝转账没有到账	存款相关问题
存款没存上	存款相关问题
网银存款没到账	存款相关问题
可不可以微信转账了	存款相关问题
我咋个充20用微信充不起了	存款相关问题
我入款成功了怎么还没到账啊	存款相关问题
我存了100账户怎么才96	存款相关问题
存款没有到账	存款相关问题
我存款50还没有到账	存款相关问题
我刚在微信上存钱怎么不到账	存款相关问题
支付宝转账50未到账	存款相关问题
我刚才充值成功了 怎么还没有到账	存款相关问题
16.18存款60没有到账	存款相关问题
你好帮忙查询存款还没到帐	存款相关问题
我存款咋还没到账呢	存款相关问题
充值没到账	存款相关问题
我存的款怎么没到账	存款相关问题
存款了还没有到账	存款相关问题
存款没到	存款相关问题
存款没到账	存款相关问题
为何我微信充了五十块，现在还没到账。	存款相关问题
我需要一个秒到账的入款方式	存款相关问题
请问哪个入款方式秒到账	存款相关问题
我充的钱怎么没有到账	存款相关问题
存款没到账	存款相关问题
我的存款怎么没存上呢	存款相关问题
存款成功未到帐	存款相关问题
刚才支付宝转了50	存款相关问题
请帮忙查询我己成功充值100元早上7：13分钟到左春娟的青岛银行卡上了可是我的游戏帐号jh1155怎么没收到充值款呢？	存款相关问题
你好！我的游戏帐号：jh1155.我今天早上7：13分成功充值100元到左春娟的青岛银行卡上了可我的游戏帐号没收到充值款请帮忙查询一下好吗？谢谢了！	存款相关问题
你好！我的游戏帐号：jh1155.我已7：13分成功充值100元到左春娟青岛银行卡上。请帮忙查询！谢谢了！	存款相关问题
早上好！我的游戏帐号：jh1155.我己充值：100元早上7：13分成功到了左春娟的青岛银行卡上可我游戏帐号没收到充值款请帮忙查询！谢谢了！	存款相关问题
昨晚到现在都没把我的存款到账	存款相关问题
存款没到账	存款相关问题
充值没到账	存款相关问题
支付宝没到帐	存款相关问题
支付宝存款到账为什么这么慢	存款相关问题
存款到账太慢	存款相关问题
我的存款怎么还没到	存款相关问题
存款没有到账	存款相关问题
我刚刚支付宝转账30怎么还未到账	存款相关问题
怎么存款没到账？	存款相关问题
存款没到账	存款相关问题
怎么充值不到账？	存款相关问题
怎么我存款转账成功我的账号还是没钱啊	存款相关问题
8点充值现在还没有到账	存款相关问题
你好 我怎么网银转账就不行啊	存款相关问题
我的存款金额不对	存款相关问题
你好，我的存款还没到账啊	存款相关问题
刚支付宝转账，现在还没到	存款相关问题
支付宝转账没到账	存款相关问题
充值没到账	存款相关问题
刚刚微信快捷支付不是秒到吗？	存款相关问题
支付宝上分半个小时了游戏上没到	存款相关问题
充值成功了还没到账	存款相关问题
意思我支付宝上分成功到账游戏上没有到	存款相关问题
存款没有到账	存款相关问题
支付宝存款没到账	存款相关问题
请问支付宝存款通道是不是不能用，我刚才试存了几元是没到账是？	存款相关问题
5分钟前在线支付3000没到账	存款相关问题
存款没到帐	存款相关问题
我支付宝转账的钱怎么还没有到账	存款相关问题
支付宝转账这么久了，怎么还没到帐	存款相关问题
支付宝充500怎么到账只有490	存款相关问题
我微信刚存款成功怎么钱没有到账了	存款相关问题
支付宝存款没有到账	存款相关问题
我刚才存的款怎么没到账	存款相关问题
怎么我微信存款没有到账?	存款相关问题
我存款金额填错	存款相关问题
我支付宝存款没有到	存款相关问题
你好 我刚存的钱怎么还没有到啊	存款相关问题
我存款还没到。	存款相关问题
存款还没到。	存款相关问题
存款怎么还没到	存款相关问题
怎么我的存款还没到	存款相关问题
怎么回事，存款还没到。	存款相关问题
充值10没到帐	存款相关问题
存款还没到。	存款相关问题
我存款没有到账	存款相关问题
充值怎么没到账？	存款相关问题
存款还没到。	存款相关问题
存款没到账	存款相关问题
存款没有到帐户	存款相关问题
我的帐号：xys258我的的转帐时间是八月二十五日零点三十七分，收款人是熊帅，支付宝显示转帐成功的时间凌晨一点零一分，我的游戏平台是老虎机NT平台，我的转帐金额额为23元！我的问题是：为什么四个多小时还没到帐？请求帮忙解决！	存款相关问题
支付宝转账不了	存款相关问题
微信存款多久到	存款相关问题
可以游戏点卡充值不	存款相关问题
尊宝主帐户没见我转的钱:哪能户内转帐呢？	存款相关问题
这么长时间怎么还没到帐呢？是熊帅的问题还是我钱转少了？我不明白？每天玩，每天转帐:从没出现昨晚到现在这种情况？	存款相关问题
零点三十七分转帐成功，凌晨一点零一分到熊帅的帐成功，到现在仍没到帐	存款相关问题
我的存款怎么还没到账	存款相关问题
为什么我存款还没到帐	存款相关问题
仍然是个老问题，就在一个多小时前我又存了23元人民币，到现在还是没能转到尊宝帐户宝！收敢人同样是熊帅！不知是何因？	存款相关问题
帮我添加存款	存款相关问题
我的存款没到账	存款相关问题
我存的钱没有到账	存款相关问题
我微信存款怎么没有到账了	存款相关问题
存款没到账	存款相关问题
你好我存款了哪个没给我分啦	存款相关问题
我的存款没有到	存款相关问题
微信100元，到帐95.5	存款相关问题
充值没到账	存款相关问题
充值没到账	存款相关问题
熊帅，我用支付宝给你尾号0535的中国工商银行银行卡转了105.00元钱已经到账了，确认下银行卡余额明细哦。	存款相关问题
存款没有到账	存款相关问题
你现在要解决我的问题。这长时间还没有解决我把支付宝转账给你们的图片发给你们了还要怎样	存款相关问题
熊帅，我用支付宝给你尾号0535的中国工商银行银行卡转了105.00元钱已经到账了，确认下银行卡余额明细哦。	存款相关问题
我的存款还没到账	存款相关问题
你好我的存款还没到账	存款相关问题
熊帅，我用支付宝给你尾号0535的中国工商银行银行卡转了105.00元钱已经到账了，确认下银行卡余额明细哦。	存款相关问题
我有一笔支付宝转账没到账	存款相关问题
怎么存款不能存	存款相关问题
我的存款为何还没到尊宝帐户呢？本人帐号：xys258，金额为22元，收歌人是熊帅，望速解决！	存款相关问题
存款到帐二十多分钟了，为何尊宝帐户里还没见钱呢？我的帐号xys258存给收毅人熊帅！支付宝显示付款成功！望速查处！	存款相关问题
支付宝转账不到帐	存款相关问题
你好。充值后多久到账啊！	存款相关问题
你好，把我账号的支付宝订单更新一下可以吗？	存款相关问题
我刚刚存400还没到账	存款相关问题
你好，我刚刚充值100块为什么到账只有95	存款相关问题
存款没到账	存款相关问题
怎么存款还没到账	存款相关问题
充的钱没到	存款相关问题
存款没到账	存款相关问题
充值成功不到账怎么办	存款相关问题
存款没到账	存款相关问题
我存款填写的30实际转了50咋办	存款相关问题
我在线支付200扣款成功怎么没有给我上分	存款相关问题
你好我充值怎么还没到帐？	存款相关问题
支付宝转账40.40怎么还不到	存款相关问题
怎么网银支付就只有三个充值银行呀	存款相关问题
网银存款没到账	存款相关问题
我支付宝冲了一块钱怎么还没有到？	存款相关问题
为什么你家充值在线银行没有建设银行	存款相关问题
我昨天晚上充的钱，现在还没到呢	存款相关问题
存款没到账	存款相关问题
昨天晚上的存款有一笔没到账	存款相关问题
存款到账了怎么还没到账户上	存款相关问题
充值的钱怎么还没有到账	存款相关问题
充值的钱还没有到账都半个小时了	存款相关问题
你好，我刚刚支付宝转款了，怎么还没有到账啊？	存款相关问题
充值的钱怎么还没有到	存款相关问题
存款附言500没到账	存款相关问题
刚刚充值的钱没有	存款相关问题
我刚刚充值的钱没有也有	存款相关问题
支付宝充值未到账	存款相关问题
网银存款没到账	存款相关问题
存款没到账	存款相关问题
我已存款80支付宝转银行卡，银行还在处理中，我的手机又突然无法截图了，现在怎么办	存款相关问题
微信收款	存款相关问题
微信扫码	存款相关问题
你好，请问可以微信支付吗？	存款相关问题
存款多久到账	存款相关问题
充值未到账	存款相关问题
我刚充值5000什么时候到账	存款相关问题
我用支付宝转账账，怎么这么慢	存款相关问题
怎么支付宝转账1个小时没有到账	存款相关问题
我刚刚存款怎么还没有到账	存款相关问题
存款没到账	存款相关问题
是不是可以理解为使用久安钱包存款可以获得总共3%的存款赠金	存款相关问题
使用久安钱包存款是加赠吗	存款相关问题
我的存款呢	存款相关问题
账号hx781223充值成功，未到账，QQ充值，金额14	存款相关问题
久安钱包怎么存	存款相关问题
存款什么时候到账	存款相关问题
你好我刚刚存款的钱怎么还没有到账了，能否帮忙查一下谢谢	存款相关问题
我刚才充值成功了  怎么还没到账?	存款相关问题
充值10元不可以呀	存款相关问题
有哪些存款方式	存款相关问题
存款没到账	存款相关问题
转账青岛银行没到账	存款相关问题
我存款怎么没有返利呀	存款相关问题
存款不到账	存款相关问题
我有一笔支付宝转账没到账请查询	存款相关问题
请帮我查一下怎么我存款成功怎么没到账	存款相关问题
怎么充值还没到账	存款相关问题
存款没到账	存款相关问题
支付宝转还没到账	存款相关问题
我刚刚存的款怎么没有啊	存款相关问题
存款没到账	存款相关问题
存款没有到账	存款相关问题
存款没到账	存款相关问题
刚刚支付宝转账到杨国祥账户转了1000没到账	存款相关问题
秒存怎么还没到	存款相关问题
存款到底多久到账	存款相关问题
存款没有到帐	存款相关问题
存款怎么没到账	存款相关问题
你们微信扫码，9块钱的手续费？？	存款相关问题
我存款，提示到账，可游戏里没到	存款相关问题
你好，刚才充值没到账	存款相关问题
我的款没到账	存款相关问题
存款怎么还没到	存款相关问题
存钱没到帐	存款相关问题
存款不到账	存款相关问题
我的充值吧不到账，你帮我看看吧	存款相关问题
怎么还没有到账	存款相关问题
存款没到账	存款相关问题
.我存的钱为什么还没到帐呢？	存款相关问题
存款到底还要多久才能到	存款相关问题
我的支付宝存款怎么没到账	存款相关问题
我用支付宝转账了。但没到游戏账号。	存款相关问题
存款不到账	存款相关问题
为什么我冲了200只有196的额度	存款相关问题
支付宝秒存不到账	存款相关问题
秒存支付宝不到账	存款相关问题
存款到帐还没得分	存款相关问题
我手机网银转账成功为何没到账	存款相关问题
充值没到	存款相关问题
存款没到账	存款相关问题
存款没到账	存款相关问题
存款没到帐	存款相关问题
为什么存款不.到帐	存款相关问题
附言支付宝转账成功钱没有到账	存款相关问题
怎么存款100只到95？	存款相关问题
充值不到账	存款相关问题
微信支付	存款相关问题
麻烦帮我处理一下我的存款	存款相关问题
充值不到账	存款相关问题
存款没有到账	存款相关问题
我存款到账十分钟了！账户没钱	存款相关问题
微信不能存款吗？	存款相关问题
充值没到账	存款相关问题
微信可以转账吗？	存款相关问题
存入未到账呢	存款相关问题
支付宝转账没到账	存款相关问题
为甚么我充值了没有到账	存款相关问题
存款到账慢	存款相关问题
支付宝存款没有到账	存款相关问题
我的存款怎么没到	存款相关问题
存款没到	存款相关问题
支付宝转账没到，彭倩冉	存款相关问题
微信存款何时到账	存款相关问题
我存款没到账	存款相关问题
充值没到账	存款相关问题
支付宝转账没到	存款相关问题
微信支付没有到账	存款相关问题
存款没到账	存款相关问题
支付宝转账没到账	存款相关问题
支付宝手机充值没到账	存款相关问题
你好存款没到	存款相关问题
支付宝存款怎么没有到	存款相关问题
存款没到账	存款相关问题
为什么我转31元成功，还不能到帐呢？昨天转了12元也同样如此！望协查解决！收款人是佟雪梅！	存款相关问题
充值没到账	存款相关问题
我支付宝转账已经到账，怎么还没有给我上钱	存款相关问题
存款不到账	存款相关问题
充值不到	存款相关问题
你好我的存款没到账	存款相关问题
存款怎么不不到账	存款相关问题
怎么没到账	存款相关问题
存款没到账	存款相关问题
存款没到账	存款相关问题
存款没有到账呢	存款相关问题
存款没到账	存款相关问题
刚存款没看见了	存款相关问题
微信存款没到账	存款相关问题
支付宝扫描没到	存款相关问题
可以微信存款不	存款相关问题
存款没到	存款相关问题
为什么存款都点不了	存款相关问题
存款网页打不开	存款相关问题
存款网页打不开	存款相关问题
支付宝转账成功，游戏没有到账	存款相关问题
充值怎么这么慢到账	存款相关问题
怎么回事我存款成功怎么号没有钱啊	存款相关问题
存款没到账啊	存款相关问题
充值成功为什么还没到账	存款相关问题
存款没到账	存款相关问题
支付宝扫描还没有到账	存款相关问题
支付宝转账没有到账呢	存款相关问题
你好！请问入款可以微信吗	存款相关问题
微信可以入款吗	存款相关问题
微信存钱没到	存款相关问题
支付宝扫描还没有到账	存款相关问题
微信存钱没到	存款相关问题
不能充不了	存款相关问题
充不了	存款相关问题
最低存款	存款相关问题
存款没有到帐	存款相关问题
存款没办法	存款相关问题
存款不能	存款相关问题
我存款成功账号没钱	存款相关问题
帮我查询我全部充了多少钱提了多少钱？	查询账号状态
我要查询我的总数？	查询账号状态
你好查询下我的签到彩金转换那个平台上了	查询账号状态
查询下签到彩金在哪个平台呢	查询账号状态
能查询下我领过木有吗	查询账号状态
给我看看我这个月一共存款多少？	查询账号状态
帮我查一下账号总存款金额	查询账号状态
查询账目	查询账号状态
你好我存里20块钱在那个游戏里了	查询账号状态
你好，账号余额不对	查询账号状态
我这个号总存款多少	查询账号状态
请问，我以前充值过没有？	查询账号状态
这个号总存款多少	查询账号状态
帮我查一下这个号的总存款和取款	查询账号状态
我也没有使用优惠。怎么还有流水限制？	查询账号状态
账户记录在哪里查	查询账号状态
你好我的充值没有到，麻烦帮我查询下	查询账号状态
网站有点卡	不能登录
app不能登录	不能登录
发下你们网站我	不能登录
网站进不去	不能登录
网址发给我	不能登录
我说还是无法登录游戏啊	不能登录
官网不能登录	不能登录
为什么我这几天都登陆不上去	不能登录
把网页版的网址发给我个	不能登录
网页版的网址给我发个	不能登录
下载PT客户端进不去	不能登录
网站是多少	不能登录
网址发给我	不能登录
网站怎么打不开啊	不能登录
网站进不去	不能登录
app怎么登陆不上去呢？	不能登录
pt客户端登录账号密码	不能登录
网页被劫持了	不能登录
为什么网页跳转到太阳城	不能登录
来个网址	不能登录
怎么网页打不开	不能登录
网址多少？	不能登录
你好尊宝的网址是多少？	不能登录
官网怎么停止访问	不能登录
我的网页怎么停止访问啊	不能登录
你们网页停止访问阿	不能登录
怎么网页停止访问呢	不能登录
怎么说停止访问了	不能登录
开不了，说停止访问了	不能登录
官网停止访问?	不能登录
停止访问什么意思	不能登录
网页咋的停止访问	不能登录
停止访问怎么处理	不能登录
优惠客服网址打不开	不能登录
停止访问是怎么回事	不能登录
请问你们的网址是多少	不能登录
网站是多少	不能登录
手机网址多少	不能登录
网站多少	不能登录
游戏网址	不能登录
游戏网址	不能登录
网址是好多	不能登录
网址是好多	不能登录
怎么登陆说被禁用	不能登录
官网不能登录游戏进不去	不能登录
我操你妈，垃圾尊宝，你们连游戏都他妈的不好好做做，每次进个游戏这个费劲，不是加载出错就是他妈的登陆不上，操你妈的	不能登录
网站多少	不能登录
网站是多少	不能登录
最新官网网址多少？	不能登录
网址发下	不能登录
把网址发给我	不能登录
尊宝网站多少	不能登录
发个网址	不能登录
把电脑版网址发一下。要不爱掉线的	不能登录
官网不能登录	不能登录
网址多少	不能登录
怎么登陆不上去呢	不能登录
无法登录	不能登录
游戏登不上去	不能登录
怎么登录不了	不能登录
游戏网站	不能登录
发个网址	不能登录
能告诉我几个备用的网址吗 www.zunbao891.com  有的时候打不开	不能登录
有能再电脑上登陆的网址吗	不能登录
网站多少	不能登录
网址是啥	不能登录
Pt客户端无法登录露露	不能登录
我新注册号下载app登录不进去	不能登录
你们官网网址多少	不能登录
电脑版地址	不能登录
电脑版地址	不能登录
电脑板网址多少	不能登录
官网有哪些?	不能登录
网站的网址	不能登录
不发来网址	不能登录
把游戏网址给我发一下	不能登录
给我域名	不能登录
官网帐号被锁了	不能登录
网站多少	不能登录
社区在哪里	不能登录
社区怎么进去	不能登录
玩家社区在哪里	不能登录
玩家社区怎么进去	不能登录
玩家社区不能登录	不能登录
社区怎么登不进去	不能登录
社区怎么进不去	不能登录
我怎么被劫持了	不能登录
官网怎么被劫持了	不能登录
我官网怎么被劫持了	不能登录
你们官网怎么被劫持了	不能登录
官网进去是别的娱乐城	不能登录
你们官网是不是被劫持了	不能登录
我怎么被狭持了	不能登录
官网怎么被狭持了	不能登录
我官网怎么被狭持了	不能登录
你们官网怎么被狭持了	不能登录
官网进去是别的娱乐城	不能登录
你们官网是不是被狭持了	不能登录
我怎么被夹持了	不能登录
官网怎么被夹持了	不能登录
我官网怎么被夹持了	不能登录
你们官网怎么被夹持了	不能登录
官网进去是别的娱乐城	不能登录
你们官网是不是被夹持了	不能登录
我怎么被挾持了	不能登录
官网怎么被挾持了	不能登录
我官网怎么被挾持了	不能登录
你们官网怎么被挾持了	不能登录
官网进去是别的娱乐城	不能登录
你们官网是不是被挾持了	不能登录
申请生日礼金	VIP咨询
普通会员能领取免费筹码？	VIP咨询
生日彩金	VIP咨询
我要领取VIP彩金邀请呀	VIP咨询
怎么我没有生日彩金	VIP咨询
我生日彩金怎么没有送、、	VIP咨询
生日彩金	VIP咨询
你们那生日彩金需要啥条件	VIP咨询
怎么生日送彩金，没送	VIP咨询
申请生日彩金	VIP咨询
申请生日礼金	VIP咨询
怎么样申请生日礼金	VIP咨询
生日彩金	VIP咨询
生日彩金	VIP咨询
在等你给我生日礼金呢	VIP咨询
app我已经下载好了，怎么还是没有呢	app咨询
app下载	app咨询
app下载彩金怎么收不到短信验证和语音	app咨询
那我想问一下我刚刚注册下载的APP为什么领取不了彩金我以前没有玩过你们游戏	app咨询
扫码下载APP网页打不开。	app咨询
下载PT客户端进不去	app咨询
下载app	app咨询
我让你发app网址	app咨询
我要复制app网址	app咨询
pt手机端	app咨询
存100只有98.下载app也没送线	app咨询
我没有手机号怎么领取APP彩金	app咨询
你好，能给我一个PT手机客户端的链接吗？	app咨询
申请注册下载APP彩金	app咨询
请问怎么领aqq彩金	app咨询
app彩金怎么领取	app咨询
不是说下载APP可以送钱嘛	app咨询
我申请了会员，也下载了APP，有没有彩金？	app咨询
手机安卓pt客户端在哪下载	app咨询
怎么没有注册下载app彩金	app咨询
我注册下载APP怎么申请不上彩金呢？	app咨询
为什么我下载不了App？	app咨询
请问我下载的App怎么没有彩金呢？	app咨询
你们九五平台有没有新注册后下载App送彩金的那个优惠活动？	app咨询
怎么我申请app彩金，说我已经申请了但是账号里没有彩金啊	app咨询
怎么不能领取App下载礼金呢	app咨询
怎么我领不到app彩金	app咨询
说下载APP领取彩金也没给我呀	app咨询
如何领取APP下载彩金a	app咨询
我是刚注册的为什么不能领App彩金呢	app咨询
app彩金打多少可以提款	app咨询
怎么下载APP彩金	app咨询
我下载了app了申请彩金是不能输入姓名	app咨询
我下载完事了怎么领APP彩金啊	app咨询
安卓PT客户端下载地址发给我	app咨询
下载彩金怎么不给	app咨询
你好，申请下载app送彩金	app咨询
我是首次注册会员，想申请下载APP奖励，陈旭是我的名字，可能重名的太多了，所以不行，能不能帮我申请，谢谢	app咨询
请问一下，APP彩金得到以后可以在什么平台玩耍？	app咨询
aqq下载	app咨询
存款没反彩金 app 下载了说我不符合 什么情况	app咨询
新用户注册下载app彩金怎么领了	app咨询
我已经下载APP了。怎么领取彩金	app咨询
不是说下载APP有免费彩金吗	app咨询
下载app的钱限制游戏吗？	app咨询
app下载地址多少	app咨询
下载app领取彩金是怎么领	app咨询
不是下载app领彩金吗？在哪领？	app咨询
帮我申请app下载彩金	app咨询
无法领取APP下载彩金收不到验证	app咨询
在哪里下载尊宝APP	app咨询
为什么我申请APP下载彩金不成功啊	app咨询
站内信，叫我下载app领取12到88彩金	app咨询
我刚注册、APP客户端也下截了、怎么申请APP优惠	app咨询
申.请下载App彩金	app咨询
领下APP	app咨询
下载APP送的有没有游戏限制	app咨询
app下载了！！申请不了啊	app咨询
app彩金收不到短信	app咨询
无法登录app	app咨询
你好，，我下载app了，，也是跟着说明一步步走的，，最后怎么没给我彩金啊	app咨询
还有是下载qpp就送彩金的、、、我已经下载完了啊、怎么没收到彩金呢？？？	app咨询
下载APP送彩金，我怎么什成功	app咨询
你好帮我查一下我申请过下载APP彩金吗clq0532	app咨询
不是注册下载app送彩金吗怎么申请	app咨询
app下载彩金不能输入名字	app咨询
注册下载app	app咨询
我怎么没有收到app彩金	app咨询
下载app送彩金是吗	app咨询
app下载彩金短信LIL怎么收不到？	app咨询
我要下载PT客户端	app咨询
我申请app为什么申请不了	app咨询
怎么APP下载彩金不能领取？	app咨询
不是有APP下载彩金么～怎么没有	app咨询
下载APP的彩金怎么领不到	app咨询
APP下载	app咨询
您好.app怎么下呢	app咨询
我下载app有个pT12元彩金，玩什么游戏?在pT里	app咨询
怎么领不到APP彩金？	app咨询
我已经提交了APP下载彩金，怎么还没派送	app咨询
我已下载APP怎么领取彩金	app咨询
aqq彩金怎么领	app咨询
你好下载APP送的彩金盈利后提款还有余额	app咨询
你好。请问APP彩金有没有游戏限制	app咨询
你好注册下载APP彩金申请怎么没有呢	app咨询
你好！我是新会员，你们有活动是下载APP送彩金，怎么申请	app咨询
我下载手机阿屁屁怎么没有彩金？	app咨询
怎么我app下好了不送彩金呢	app咨询
我注册手机APP怎么没有彩金啊	app咨询
我领去下载app彩金怎么手机收不了信息呢	app咨询
你好，查询我可以申请app彩金吗	app咨询
我注册。也下载app了。。没给我彩金	app咨询
你好。平板可以下载这游戏吗	app咨询
我的资料都完善了那个下载app彩金领取说我没完善	app咨询
下载app所得彩金多少能取款？	app咨询
下载app送彩金取款要求？	app咨询
怎么没有体检金，我下了APP的	app咨询
你好，给我一个pt客户端下载地址	app咨询
怎么没有app彩金	app咨询
APP怎么进不去	app咨询
app怎么登陆不了？	app咨询
你好，为何我下载app无法领取彩金呢？	app咨询
发个PT客户端下载网址	app咨询
发个PT客户端下载网址	app咨询
手机pt客户端的下载连接有没有	app咨询
ptapp在哪下	app咨询
下载了App还没领	app咨询
怎么APP彩金领不到	app咨询
为什么领不到aqq彩金	app咨询
资料都填写完了app也下完了怎么没给彩金？	app咨询
APP自助彩金填写真实姓名的页面怎么打不开啊	app咨询
不小心在PTAPP输入多次错误密码，麻烦你帮我下	app咨询
怎样下载pt老虎机客服端？	app咨询
申请app彩金	app咨询
app下载彩金怎么领取	app咨询
下载APP领取彩金	app咨询
你好！我已下载app在哪里领彩金	app咨询
我申请下载APP那个怎么没送给我	app咨询
需要下载APP吗	app咨询
注册帐号是下载APP上面注册了绑定银行卡吗？	app咨询
怎么下了APP第一次注册没送彩金	app咨询
app下载的彩金可以玩大蓝吗	app咨询
app下载的彩金可以玩pt的大蓝吗	app咨询
为什么我申请领app彩金不可以领呢	app咨询
我刚注册的游戏，下载手机app送彩金，送多少呀	app咨询
我下了app怎么不送彩金	app咨询
我的APP彩金申请不了	app咨询
App彩金	app咨询
下载APP送彩金我怎么没有	app咨询
你听不明白吗我是问注册新帐号有58元彩金吗？不是问APP下载彩金	app咨询
新会员申领下载APP优惠彩金	app咨询
下载APP怎么申请彩金	app咨询
下载app没彩金呢	app咨询
为什么我申请下载App彩金说我注册资料重复	app咨询
下载APP赠送的彩金，什么提款条件啊	app咨询
为什么无法申请手机App彩金	app咨询
下载AP没有彩金送	app咨询
我下载app了怎么领取不了app彩金	app咨询
app彩金在什么平台	app咨询
资讯重复不能申请APP彩金什么意思？	app咨询
app下载完了怎么领彩金	app咨询
下载app送彩金？	app咨询
下载app了彩金什么时候给	app咨询
app彩金下款有什么要求	app咨询
app彩金	app咨询
为什么领不了app彩金	app咨询
我领app彩金可我以前的号码没用了	app咨询
注册18彩金是骗人的？下载app彩金也是骗人的	app咨询
下载ApP红包	app咨询
怎么下载App	app咨询
下载app咋得彩金啊	app咨询
我的下载APP奖金为什么没有？	app咨询
我想问问下载APP领取答题彩金怎么领取发	app咨询
下载APP领取不了彩金	app咨询
下载app领彩金怎么领？	app咨询
不是下载app就送彩金吗？	app咨询
我从来就没领取过AP|P奖励，什么说资料从复。浏览器注册，APP注册。就不能领取吗？	app咨询
那个APP下载金你帮我查下我申请过没有	app咨询
填写问卷，登陆APP领取12-88彩金	app咨询
下截了尊宝App，怎么奖金迟迟不到账泥？	app咨询
为什么我不能领取下载app彩金勒	app咨询
下载qpp彩金领取	app咨询
不是下载了送钱吗	app咨询
下载了app彩金没到	app咨询
我下载了APP怎么没有彩金	app咨询
我申请你们APPP彩金	app咨询
我下载了APP怎么没有彩金	app咨询
已下载app,送彩金	app咨询
就是我不是用手机玩游戏就申请不到APP彩金哟	app咨询
我用电脑可以申请APP彩金吗	app咨询
下载PT客户端发给我	app咨询
下载PT客户端链接发给我	app咨询
App彩金	app咨询
领取APP出现系统繁忙	app咨询
为何禁言	app咨询
朋友圈无法发言	app咨询
下载APP	app咨询
玩家动态是什么	app咨询
动态被禁言	app咨询
为什么禁严我的动态	app咨询
好友圈禁言	app咨询
为什么我的好友圈不能发言	app咨询
为什么禁言我好友圈	app咨询
我的动态为什么不能发言	app咨询
动态不能发言	app咨询
朋友圈不能发言	app咨询
