登陆账号送128彩金	咨询当下相关活动
申请存10到20彩金	咨询当下相关活动
输了几千有什么优惠可以申请吗	咨询当下相关活动
你们存够200还给18元彩金了？	咨询当下相关活动
积分只可以兑换今天的，昨天投注的今天能不能兑换	咨询当下相关活动
是不是下载久安钱包就可以领彩金	咨询当下相关活动
签到礼金流水？	咨询当下相关活动
那个下什么久APP送5元彩金活动结束了吗	咨询当下相关活动
申请128彩金	咨询当下相关活动
自助彩金怎么领取	咨询当下相关活动
收到邮件邀请送132彩金	咨询当下相关活动
签到余额怎么转出来	咨询当下相关活动
帮我看看我有没有彩金	咨询当下相关活动
亲下载久安钱包送彩金吗	咨询当下相关活动
没有注单奖和有效投注优惠活动吗	咨询当下相关活动
申请存200送18优惠	咨询当下相关活动
我存款200+按你要求领取优惠怎么不能领取	咨询当下相关活动
现在有冲多少送的活动吗	咨询当下相关活动
你好我收到你们发的邮件，有彩金送？	咨询当下相关活动
优惠可以提现不	咨询当下相关活动
亲签到额度可以拿出来打鱼吗	咨询当下相关活动
我接到客服电话说有彩金可以领?	咨询当下相关活动
存款送彩金吗	咨询当下相关活动
充值彩金	咨询当下相关活动
帮我领彩金	咨询当下相关活动
彩金如何领	咨询当下相关活动
申请西天取经	咨询当下相关活动
我收到邮件说有彩金，怎么没有？	咨询当下相关活动
我下载久安了，怎么领取彩金？	咨询当下相关活动
优惠活动	咨询当下相关活动
刚刚有个客服打电话我说领彩金怎么领	咨询当下相关活动
限時優惠	咨询当下相关活动
活动有嘛	咨询当下相关活动
存款送彩金吗	咨询当下相关活动
我收到短信说存3o送58	咨询当下相关活动
申请彩金	咨询当下相关活动
给我申请优惠彩金	咨询当下相关活动
刚有个客服给我打电话说给我彩金？	咨询当下相关活动
请问一下，送的彩金只能玩什么游戏，多少可以取款？	咨询当下相关活动
给我申请优惠彩金	咨询当下相关活动
给我申请个优惠彩金	咨询当下相关活动
申请存送彩金	咨询当下相关活动
我站内信里看到存30送21。真的吗	咨询当下相关活动
那个存30送21在哪里申请?	咨询当下相关活动
有注册送132的活动吗？	咨询当下相关活动
申请存款送钱活动	咨询当下相关活动
我申请存200送18元	咨询当下相关活动
活动有吗	咨询当下相关活动
你好啊七夕搭鹊桥这个活动中的神秘宝箱彩金需要多少倍流水啊谢谢	咨询当下相关活动
存送红包	咨询当下相关活动
没有存送红包	咨询当下相关活动
申请彩金	咨询当下相关活动
有哪些优惠	咨询当下相关活动
女神阵营优惠	咨询当下相关活动
阵营战开了吗	咨询当下相关活动
申请彩金	咨询当下相关活动
为何我没申请过贵公司游戏，怎么第一次申请也没有礼金？	咨询当下相关活动
你们发了邮件给我说送128怎么领取	咨询当下相关活动
申请支付宝转账红包	咨询当下相关活动
申请充值就送钱活动内容：充值就送钱活动时间：2018年7月20日开启显示详情>>	咨询当下相关活动
签到的彩金不能转换吗	咨询当下相关活动
充100送红包	咨询当下相关活动
刚存了100，有红包吗	咨询当下相关活动
你好帮我申请下存送优惠	咨询当下相关活动
为什么不能领签到金	咨询当下相关活动
怎不能领签到彩金	咨询当下相关活动
我的签到彩金呢？	咨询当下相关活动
我的签到彩金怎么不能转	咨询当下相关活动
签到根本不能领	咨询当下相关活动
申请西天取经彩金	咨询当下相关活动
7月20号开的活动	咨询当下相关活动
限时百分百优惠还可以申请吗	咨询当下相关活动
没送彩金	咨询当下相关活动
给我打电话不是有什么活动吗	咨询当下相关活动
送的彩金在哪里玩？	咨询当下相关活动
有啥优惠	咨询当下相关活动
签到彩金就4元，能不能转到游戏中玩	咨询当下相关活动
你好，我刚收到短信，存30送59，对吗	咨询当下相关活动
我手机收到短信。说今天存30送59元	咨询当下相关活动
签到彩金	咨询当下相关活动
西天取金是什么活动	咨询当下相关活动
西天取金活动	咨询当下相关活动
如何申请西天取金彩金	咨询当下相关活动
刚才说登录送彩金是吗？	咨询当下相关活动
参加充值就送活动	咨询当下相关活动
你好！在哪里领红包。七夕礼物啊	咨询当下相关活动
收到短信隐藏彩金68	咨询当下相关活动
荷花在哪里领	咨询当下相关活动
领取眷侣荷花	咨询当下相关活动
情人节优惠	咨询当下相关活动
在什么地方签到？	咨询当下相关活动
申请存款200送18彩金	咨询当下相关活动
帮我查一下我可以申请存30送21活动吗	咨询当下相关活动
申请久安支付红包	咨询当下相关活动
存送优惠	咨询当下相关活动
存款赠送	咨询当下相关活动
说我帐号有彩金赠送	咨询当下相关活动
请问有分享彩金吗	咨询当下相关活动
优惠活动	咨询当下相关活动
申请这个彩金	咨询当下相关活动
申请邮件132彩金	咨询当下相关活动
怎么申请千百倍活动	咨询当下相关活动
自助存送优惠怎么不用显示？	咨询当下相关活动
你好我想问下会员日礼金找你领吗	咨询当下相关活动
帮我查一下 我可以申请存30送21活动吗	咨询当下相关活动
存送几倍流水	咨询当下相关活动
我可以申请存30送21活动吗	咨询当下相关活动
存款一百送200多少流水	咨询当下相关活动
收到邮件领取38彩金	咨询当下相关活动
请问 你们说的送彩金在哪里？？	咨询当下相关活动
新注册的账号想申请奖励	咨询当下相关活动
活动2018取金	咨询当下相关活动
申请充值就送活动	咨询当下相关活动
在吗怎么申请会员周年日	咨询当下相关活动
我咋申请存三十送六十八的优惠啊亲	咨询当下相关活动
咋能在邮箱里面看到的优惠说给我26彩金啊	咨询当下相关活动
万众红包网打车卷	咨询当下相关活动
申请存款礼金	咨询当下相关活动
申请邮箱彩金	咨询当下相关活动
签到彩金也不能领	咨询当下相关活动
申请彩金	咨询当下相关活动
客服刚打电话说还有什么活动	咨询当下相关活动
存款送红包是吗？	咨询当下相关活动
存款200送红包是吗	咨询当下相关活动
签到金需要流水倍数吗	咨询当下相关活动
新用户优惠	咨询当下相关活动
有送彩金吗	咨询当下相关活动
申请18元彩金	咨询当下相关活动
2018取金活动	咨询当下相关活动
签到红包里面红包怎么不能用得呢	咨询当下相关活动
签到金激活要求	咨询当下相关活动
单月存款多少激活签到金	咨询当下相关活动
你好存50送58这个优惠能申请吗	咨询当下相关活动
我收到你们给我发的邮件存100送108，叫我联系在线客服	咨询当下相关活动
那个活动可以领么	咨询当下相关活动
荷花红包码没复制下来…在哪看	咨询当下相关活动
周年优惠	咨询当下相关活动
目前有什么活动吗	咨询当下相关活动
存款打卡奖金可以玩PT吗	咨询当下相关活动
slot存送45%优惠最低存款多少？	咨询当下相关活动
存款送彩金	咨询当下相关活动
申请88	咨询当下相关活动
你们发邮件叫我来领取88元	咨询当下相关活动
申请邮箱彩金	咨询当下相关活动
存款了跟你领红包吗	咨询当下相关活动
申请彩金	咨询当下相关活动
我是前几天注册的怎么激活签到金	咨询当下相关活动
怎么签到金不能转出	咨询当下相关活动
你好，我申请30松21，说我的存款没达到要求	咨询当下相关活动
你好，领去充值彩金	咨询当下相关活动
邮件提示派发59彩金吗？我怎么没有收到	咨询当下相关活动
你好，我是可以领周年彩金啊？	咨询当下相关活动
签到需要存款多少才能转账	咨询当下相关活动
申请千百倍奖金	咨询当下相关活动
那个存款就送8元申请	咨询当下相关活动
不是存30有优惠21吗	咨询当下相关活动
存款30优惠21在哪	咨询当下相关活动
不是有优惠活动存30送21	咨询当下相关活动
请问签到余额怎么转到主账户	咨询当下相关活动
领彩金	咨询当下相关活动
账号申请下载久安钱包APP彩金	咨询当下相关活动
我签到得4彩金怎么用不了？	咨询当下相关活动
存送活动百分45。最低入款标准	咨询当下相关活动
存送最低入款多少	咨询当下相关活动
pt存送%45最低入款标准	咨询当下相关活动
你好，申请128彩金	咨询当下相关活动
申请128彩金	咨询当下相关活动
有什么优惠	咨询当下相关活动
邮件告诉我说联系你领彩金	咨询当下相关活动
你好，我现在签到余额还差多少激活啊	咨询当下相关活动
我的积分可以换彩金吧	咨询当下相关活动
积分兑换彩金	咨询当下相关活动
申请红包	咨询当下相关活动
我想申请存一百送五十	咨询当下相关活动
首次注册有什么优惠吗	咨询当下相关活动
新注册的会员有优惠吗	咨询当下相关活动
申请存款彩金	咨询当下相关活动
收到邮件说送128	咨询当下相关活动
签到彩金要打多少流水	咨询当下相关活动
申请存款送红包	咨询当下相关活动
第一次注册居然领不到彩金	咨询当下相关活动
注册了还不送	咨询当下相关活动
我收到你们的邮件存100送108，需要流水多少倍	咨询当下相关活动
申请充值就送钱	咨询当下相关活动
申请彩金132	咨询当下相关活动
签到积分	咨询当下相关活动
申请存款红包	咨询当下相关活动
我想申请会员周年日活动	咨询当下相关活动
用戶，凭图领【38】菜进首存50道长118限10名高返水不掉级威信zunbao01vip领网之www点zb0009点com。45A	咨询当下相关活动
签到彩金需要多少倍流水	咨询当下相关活动
申请优惠千百倍	咨询当下相关活动
客服说我七夕那天存款30就有18红包一个然后我存款了客服就不理人了	咨询当下相关活动
收到邮件说赠送我68元彩金	咨询当下相关活动
申请88彩金	咨询当下相关活动
为什么签到红包不能用	咨询当下相关活动
申请存款红包	咨询当下相关活动
你好.收到邮件申请88彩金	咨询当下相关活动
收到短信领取回归彩金，怎么领取	咨询当下相关活动
回归彩金	咨询当下相关活动
申请礼金	咨询当下相关活动
你好怎么领取彩金	咨询当下相关活动
你好我帮卡成功怎么领取彩金	咨询当下相关活动
帮我看看有什么优惠可以申请	咨询当下相关活动
千百倍，有什么奖励	咨询当下相关活动
申请西天取经	咨询当下相关活动
那个七夕奖励怎么还没发，	咨询当下相关活动
周年金	咨询当下相关活动
我刚刚领取七夕彩金但是我完了复制代码，麻烦帮我查查谢谢	咨询当下相关活动
你好，查下我签到余额还有多少可以激活	咨询当下相关活动
签到彩金充值多少才能激活	咨询当下相关活动
怎么申请彩金	咨询当下相关活动
有优惠活动吗	咨询当下相关活动
签到领取四元，一个月存多少钱才可以拿出来	咨询当下相关活动
积分怎么用	咨询当下相关活动
积分兑换	咨询当下相关活动
领取68彩金	咨询当下相关活动
你好，我收到短信说凭图领26彩金	咨询当下相关活动
今天有什么活动	咨询当下相关活动
申请存款升级奖金	咨询当下相关活动
收到短信26彩金	咨询当下相关活动
凭图领26	咨询当下相关活动
七夕存款大于500就可以领红包那个活动是从哪天开始算存款	咨询当下相关活动
申请68元彩金，收到短信的	咨询当下相关活动
申请68元彩金	咨询当下相关活动
周年彩金	咨询当下相关活动
申请132元彩金	咨询当下相关活动
我今天接到你们客服电话，说有充值送100%的活动可以参加？	咨询当下相关活动
下载了，免费送彩金吗	咨询当下相关活动
签到金不能游戏吗？	咨询当下相关活动
申请存款就送优惠卷活动	咨询当下相关活动
申请充值送礼金	咨询当下相关活动
申请这个活动	咨询当下相关活动
积分兑换不	咨询当下相关活动
收到短信26	咨询当下相关活动
积分怎么换	咨询当下相关活动
积分怎么兑换	咨询当下相关活动
积分换彩金	咨询当下相关活动
换积分	咨询当下相关活动
积分哪里换	咨询当下相关活动
积分是什么	咨询当下相关活动
有积分吗	咨询当下相关活动
收到邮件送彩金	咨询当下相关活动
收到电话送彩金	咨询当下相关活动
刚刚打电话来说送彩金	咨询当下相关活动
你们打电话给我说有彩金送	咨询当下相关活动
邮件送彩金	咨询当下相关活动
截图送彩金	咨询当下相关活动
邮件说截图送58	咨询当下相关活动
凭图送彩金	咨询当下相关活动
收到邮件凭图送彩金	咨询当下相关活动
电话送彩金	咨询当下相关活动
短信送彩金	咨询当下相关活动
收到短信送彩金	咨询当下相关活动
短信上说截图送彩金	咨询当下相关活动
短信上说凭图送彩金	咨询当下相关活动
我第一次注册有送吗	咨询当下相关活动
我第一次游戏有送吗	咨询当下相关活动
领会员日彩金	咨询当下相关活动
会员日彩金	咨询当下相关活动
会员日礼金	咨询当下相关活动
周年会员日彩金	咨询当下相关活动
申请会员日彩金	咨询当下相关活动
会员日彩金怎么申请	咨询当下相关活动
会员日活动	咨询当下相关活动
申请会员日	咨询当下相关活动
申请会员日礼金	咨询当下相关活动
申请周年日礼金	咨询当下相关活动
申请周年日彩金	咨询当下相关活动
我转BB电子应该转那里	转账咨询
mg是在PT钱包还是在老虎机钱包	转账咨询
PT？转主帐户不能转	转账咨询
钱来捕鱼怎么转钱	转账咨询
钱来捕鱼转到哪个平台	转账咨询
PT转到什么平台	转账咨询
钱来捕鱼怎么提现	转账咨询
亲，为何我pT存款拉不回主帐户	转账咨询
从PT帐户回收到主帐户不行呢？	转账咨询
为何户内转帐不了	转账咨询
？我转到ag的钱哪里去了？	转账咨询
怎么显示我的账号不能转账操作呢	转账咨询
显示我的账号不能转账操作？	转账咨询
老虎机钱包有什么平台	转账咨询
老虎机帐户是什么	转账咨询
老虎机怎玩	转账咨询
帮我查一下我的名字叫罗斌电话15281324001有没有注册帐户	转账咨询
注册彩金才老虎机钱包里。不用转了。直接可以玩电子游戏了是吧	转账咨询
游戏账户间不可对转	转账咨询
找不到转账平台	转账咨询
老虎机游戏有什么平台	转账咨询
app无法户内转账怎么办	转账咨询
你好SLOT是那些游戏呀	转账咨询
看自助存送老虎机钱包优惠有项SLOT存送是玩老虎机的吗	转账咨询
钱在老虎机账户里面，我申请的时候忘记了，我想把老虎机钱转到PT可以吗？	转账咨询
为什么我主账户不能转入游戏账户	转账咨询
为什么不能户内转账	转账咨询
去别的游戏。我充值应该冲在哪里？还是pt吗？	转账咨询
我去MG玩。充值应该冲在哪里？还是PT可以吗	转账咨询
老虎机钱包里面有哪些平台	转账咨询
dt要转帐到哪个平台	转账咨询
png要转帐到哪里？	转账咨询
转帐不无法	转账咨询
怎么转帐	转账咨询
什么是户内转帐	转账咨询
户内转帐	转账咨询
我PT的钱要转去DT平台	转账咨询
我钱平台要转去平台	转账咨询
我PT的钱要转帐去DT平台	转账咨询
dt要转到哪个平台	转账咨询
捕鱼怎么转帐	转账咨询
我玩捕鱼要转到哪里	转账咨询
为啥我玩捕鱼里面没钱	转账咨询
我玩钱来捕鱼要转帐到哪个平台	转账咨询
捕鱼转哪	转账咨询
捕鱼钱转哪	转账咨询
捕鱼没钱从哪转	转账咨询
我账号里有钱到捕鱼里没钱	转账咨询
我想玩捕鱼要转到哪	转账咨询
捕鱼的钱要转哪个平台	转账咨询
我要转账到哪个平台? 我玩捕鱼	转账咨询
我玩捕鱼王，怎么转帐	转账咨询
打鱼那游戏怎么转帐	转账咨询
捕鱼游戏转账到哪	转账咨询
我怎么没找到捕鱼平台可以转帐	转账咨询
我想玩捕鱼不知道怎么转帐	转账咨询
告诉我捕鱼转到哪里才能玩	转账咨询
转到哪里可以玩捕鱼?	转账咨询
一件回归的钱到哪了	转账咨询
一键回归的钱呢?	转账咨询
一键转出后的钱在哪?	转账咨询
一键转出怎么转不出来	转账咨询
一键回归怎么不行	转账咨询
为啥我一键回归PT无法转出	转账咨询
为啥我一键转出有流水限制	转账咨询
为啥我一键回归不能操作	转账咨询
为啥我一键转出没有钱	转账咨询
一键回归了 钱呢	转账咨询
一键返回了  钱在哪	转账咨询
我刚刚操作一键转出 钱回哪去了	转账咨询
我按了一键转出 没看到钱	转账咨询
我点了一键回归，输的钱没回归	转账咨询
我想用一键转出，不能点	转账咨询
我想点一键回归，却没反应	转账咨询
老虎机钱包可以玩啥	转账咨询
我要玩MG转到哪	转账咨询
我要玩PT转到哪	转账咨询
我要玩DT转到哪	转账咨询
我要玩QT转到哪	转账咨询
我要玩NT转到哪	转账咨询
我要玩PNG转到哪	转账咨询
我要玩SW转到哪	转账咨询
我找不到MG可以转帐	转账咨询
我找不到DT可以转帐	转账咨询
我找不到QT可以转账	转账咨询
我找不到PNG可以转帐	转账咨询
我找不到SW可以转帐	转账咨询
我转到了老虎机钱包可以玩什么	转账咨询
我转到了SLOT可以玩什么	转账咨询
我玩MG的，要转哪里	转账咨询
我转账到老虎机钱包，进PT没钱	转账咨询
转账没有MG选项	转账咨询
转账地方没有DT选项	转账咨询
户内转账没有MG可以选	转账咨询
SLOT有哪些平台可以玩	转账咨询
老虎机钱包能玩BBIN吗	转账咨询
SLOT是什么平台	转账咨询
老虎机钱包是哪个平台	转账咨询
我钱在老虎机钱包能玩什么	转账咨询
我想玩老虎机要转到哪	转账咨询
老虎机钱包能玩啥	转账咨询
为什么我的账号被禁用了呢	账号解锁、忘记账号
忘记账号了	账号解锁、忘记账号
请帮忙查询15502872203是绑定的哪个帐号	账号解锁、忘记账号
我忘了自己帐号了，怎么找回来	账号解锁、忘记账号
忘记帐号	账号解锁、忘记账号
查一下账号	账号解锁、忘记账号
亲，帮我把我帐号解锁，提不了款	账号解锁、忘记账号
帮忙查哈我的账号	账号解锁、忘记账号
账户是什么哦	账号解锁、忘记账号
你好，不记得账号了	账号解锁、忘记账号
帐号被锁	账号解锁、忘记账号
忘记了会员账号	账号解锁、忘记账号
账号锁定	账号解锁、忘记账号
忘了账号	账号解锁、忘记账号
帮我查查游戏账号忘记	账号解锁、忘记账号
忘记账号密码	账号解锁、忘记账号
忘记会员账号能查询一下告诉我	账号解锁、忘记账号
解锁帐号	账号解锁、忘记账号
忘记帐号	账号解锁、忘记账号
帐号禁用	账号解锁、忘记账号
我忘记账号了	账号解锁、忘记账号
忘记帐号了	账号解锁、忘记账号
忘记帐号	账号解锁、忘记账号
忘记密码和账号了	账号解锁、忘记账号
你好客服我忘记我会员号了	账号解锁、忘记账号
我忘记我的会员号了	账号解锁、忘记账号
帮我把账号解封	账号解锁、忘记账号
账号锁死了	账号解锁、忘记账号
我账号不记得了	账号解锁、忘记账号
你好为什么禁用我的账号？	账号解锁、忘记账号
账号锁了	账号解锁、忘记账号
亲你好我账号密码忘记了麻烦查询一下	账号解锁、忘记账号
忘记帐号	账号解锁、忘记账号
我忘记了账号和密码	账号解锁、忘记账号
账号忘记了，怎么找回	账号解锁、忘记账号
我忘记帐号了	账号解锁、忘记账号
账号锁上了	账号解锁、忘记账号
账号解冻	账号解锁、忘记账号
账号解封	账号解锁、忘记账号
账号密码忘记了	账号解锁、忘记账号
您好！查询账号	账号解锁、忘记账号
你好我的帐号被临时冻结了，请解下	账号解锁、忘记账号
你好，帮我看看我的帐号，怎么被禁用了?	账号解锁、忘记账号
我的账户被冻结了	账号解锁、忘记账号
我帐号被冻结了	账号解锁、忘记账号
账号解锁密码	账号解锁、忘记账号
帮我查一下我的账号是多少了	账号解锁、忘记账号
我的账户解冻	账号解锁、忘记账号
说我密码锁了，	账号解锁、忘记账号
亲你好有点事很长时间没上尊宝游戏了账号和秘码都忘了能帮查一下吗	账号解锁、忘记账号
我号被封了	账号解锁、忘记账号
帐号怎被锁了	账号解锁、忘记账号
帐号解锁	账号解锁、忘记账号
帐号锁著了	账号解锁、忘记账号
忘记帐号	账号解锁、忘记账号
给我查一下我的账号	账号解锁、忘记账号
忘记帐号	账号解锁、忘记账号
我的帳號無法登錄，而且被临时冻结了麻烦你解冻一下谢謝！	账号解锁、忘记账号
账号密码被冻结了	账号解锁、忘记账号
帐号锁了	账号解锁、忘记账号
请问我的用户名是多少	账号解锁、忘记账号
我想查询老虎机游戏	游戏咨询
我想查询老虎机游戏	游戏咨询
我想查询老虎机游戏	游戏咨询
查询老虎机游戏	游戏咨询
查询老虎机游戏	游戏咨询
登陆APP前面加什么字母	游戏咨询
游戏前面加什么	游戏咨询
如何查游戏记录	游戏咨询
游戏记录查询	游戏咨询
游戏记录	游戏咨询
怎查游戏记录	游戏咨询
bbin怎查游戏记录	游戏咨询
真人游戏记录	游戏咨询
捕鱼游戏记录	游戏咨询
今天哪些游戏出分	游戏咨询
老虎机怎么玩	游戏咨询
现在pt什么游戏出分	游戏咨询
前缀是什么	游戏咨询
ptdt出分游戏	游戏咨询
PTDt出分游戏	游戏咨询
赔付不对	游戏咨询
麻凡查询目前出分游戏	游戏咨询
帮我查询游戏局号	游戏咨询
PT现在哪个游戏出分高	游戏咨询
我想玩百家乐	游戏咨询
我想玩mg	游戏咨询
pt手机端前缀加什么	游戏咨询
迩好，迩游戏平台有没有一个游戏叫跳高高，的其他平台是在传奇游戏	游戏咨询
怎么没有电子游戏	游戏咨询
我想知道百家乐怎么玩	游戏咨询
百家乐是什么	游戏咨询
PT客户端登录账号前加什么	游戏咨询
PT客户端前缀	游戏咨询
你好，pt游戏怎么没有吉祥8	游戏咨询
百家乐怎么玩	游戏咨询
目前提供哪些百家乐	游戏咨询
百家乐怎么玩	游戏咨询
我想查询老虎机游戏	游戏咨询
百家乐怎么玩	游戏咨询
老虎机游戏	游戏咨询
百家乐是什么	游戏咨询
百家乐游戏	游戏咨询
老虎机笔笔存送	游戏咨询
我的中奖金额是不是有误	游戏咨询
怎么进入奖池	游戏咨询
什么是赌博功能	游戏咨询
什么是多旋转游戏	游戏咨询
有什么游戏	游戏咨询
百家乐是怎么玩	游戏咨询
老虎机怎么玩	游戏咨询
百家乐怎么玩	游戏咨询
目前提供哪些百家乐	游戏咨询
我不会玩老虎机	游戏咨询
老虎机好难我不会	游戏咨询
我要玩游戏	游戏咨询
百家乐是什么	游戏咨询
篮球结算好慢	游戏咨询
我问的篮球还不结算	游戏咨询
那你不回答我篮球结算慢的问题?	游戏咨询
钱来捕鱼怎么登陆啊	游戏咨询
钱来捕鱼app下载后，登录需要加什么符号吗？怎么我的账号进不去呢	游戏咨询
你好，登录app前后面需要加什么符号吗？	游戏咨询
手机客服端登录前面加个什么字母	游戏咨询
手机客服端我怎么登录	游戏咨询
pt在账号前面加什么	游戏咨询
你好，登录手机pt客户端需要加前缀吗	游戏咨询
手机登录pt游戏加前缀吗	游戏咨询
投注了没有记录	游戏咨询
不知道从哪里进入游戏	游戏咨询
PT客服端登录前面加什么	游戏咨询
PT游戏账号前加什么字母啊	游戏咨询
金钱蛙在pt还是老虎机？	游戏咨询
下载PT客户端前缀加什么字母	游戏咨询
现在有哪些百家乐	游戏咨询
那百家乐是什么	游戏咨询
怎么查游戏记录	游戏咨询
怎么查询老虎机游戏记录	游戏咨询
bb的账号怎么填写	游戏咨询
bb怎么登账号	游戏咨询
百家乐怎玩	游戏咨询
赌博功能	游戏咨询
今天的出分游戏	游戏咨询
游戏玩法	游戏咨询
PT客户端登入要加什么	游戏咨询
pt客户端前面加什么	游戏咨询
千百倍查询单号怎么查	游戏咨询
pt游戏在哪玩	游戏咨询
我不会玩老虎机	游戏咨询
老虎机怎么玩	游戏咨询
老虎机怎么玩	游戏咨询
老虎机游戏玩法	游戏咨询
百家乐怎么玩	游戏咨询
百家乐游戏玩法	游戏咨询
捕鱼怎么玩	游戏咨询
捕鱼游戏玩法	游戏咨询
游戏怎么玩	游戏咨询
怎么玩啊游戏	游戏咨询
这游戏怎么玩阿	游戏咨询
我第一次玩这游戏不会啊	游戏咨询
奖池是什么	游戏咨询
奖池游戏是什么	游戏咨询
什么是奖池	游戏咨询
怎么玩奖池	游戏咨询
怎么进奖池	游戏咨询
奖池要怎么进去	游戏咨询
我不知道什么是奖池	游戏咨询
奖池的玩法是什么	游戏咨询
如何进去奖池	游戏咨询
什么是翻倍	游戏咨询
翻倍是什么	游戏咨询
翻倍游戏是什么	游戏咨询
什么是翻倍游戏	游戏咨询
赌博游戏是什么	游戏咨询
老虎机里的赌博游戏是什么	游戏咨询
奖金翻倍游戏是什么	游戏咨询
什么是奖金翻倍游戏	游戏咨询
什么是赌博游戏	游戏咨询
奖金翻倍怎么玩	游戏咨询
怎么玩奖金翻倍	游戏咨询
奖金翻倍游戏算流水吗	游戏咨询
奖池计算流水吗	游戏咨询
什么是翻倍	游戏咨询
翻倍计算流水吗	游戏咨询
赌博计算流水吗	游戏咨询
多旋转是什么	游戏咨询
什么是多旋转游戏	游戏咨询
什么是多旋转	游戏咨询
怎样才叫多旋转	游戏咨询
什么游戏室多旋转	游戏咨询
多旋转游戏有哪些	游戏咨询
多旋转游戏是什么	游戏咨询
多旋转游戏怎么玩	游戏咨询
怎么玩多旋转游戏	游戏咨询
mg多旋转游戏	游戏咨询
pt多旋转游戏	游戏咨询
我进不去游戏了，玩不了了，还把分给我吃掉了	游戏进不去
出现常规错误，请于支持人员联系。。MG电子游戏，打不开。	游戏进不去
pt进不去	游戏进不去
pt怎进不去	游戏进不去
pt不能进	游戏进不去
pt怎不能玩	游戏进不去
pt不能玩	游戏进不去
pt不能进去	游戏进不去
mg进不去	游戏进不去
mg怎不能进了	游戏进不去
mg怎不能玩了	游戏进不去
mg不可以玩吗？	游戏进不去
mg怎不能玩了	游戏进不去
mg出现错误代码11	游戏进不去
mg不能进去	游戏进不去
怎不能进去游戏了	游戏进不去
我打不开游戏	游戏进不去
mg不能进去	游戏进不去
游戏不能玩	游戏进不去
png怎不可以玩了	游戏进不去
游戏怎不可以玩了	游戏进不去
我游戏还是进不去	游戏进不去
游戏打不开	游戏进不去
nt不能玩了	游戏进不去
dt怎不能进去	游戏进不去
游戏不能玩	游戏进不去
游戏怎打不开了	游戏进不去
游戏不能玩	游戏进不去
pt怎么不能进了	游戏进不去
MG游戏进不去	游戏进不去
不能加载游戏	游戏进不去
游戏不能进	游戏进不去
pt不可以进啊	游戏进不去
怎么进不去了啊游戏	游戏进不去
DT游戏一直没法玩	游戏进不去
dt怎么不能玩了	游戏进不去
pt进不去	游戏进不去
png玩不了	游戏进不去
为什么我进PT进不去	游戏进不去
怎么进不了游戏？	游戏进不去
游戏掉线进不去	游戏进不去
你好，棋牌游戏用什么软件打开.json?	游戏进不去
网站上的PT游戏为什么打不开	游戏进不去
游戏玩不了	游戏进不去
怎么进不去游戏	游戏进不去
怎么进不去游戏	游戏进不去
pt现在不能玩吗	游戏进不去
pt现在怎么进不去	游戏进不去
为什么不能玩	游戏进不去
pt怎么不能进阿	游戏进不去
pt游戏不能进	游戏进不去
dt怎么进不去啊	游戏进不去
dt怎么不能进阿	游戏进不去
dt游戏不能进啊	游戏进不去
电话号码绑定错了最后一个数	修改账号资料
我想要把那个手机号给换了	修改账号资料
注册电话怎样修改	修改账号资料
我能改下电话号码吗	修改账号资料
注册姓名能够改吗	修改账号资料
生日日期写错了	修改账号资料
我生日日期打错了	修改账号资料
注册姓名错误	修改账号资料
我申请了账号，怎么修改我填的电话号码	修改账号资料
手机号码注册的时候填错了，可以换么	修改账号资料
手机号码换了怎么办	修改账号资料
可以改下手机号码吗	修改账号资料
改手机号码	修改账号资料
我忘记注册的电话是哪个了	修改账号资料
我忘记我的注册邮箱了	修改账号资料
我改一下手机号	修改账号资料
我想修改一下手机号	修改账号资料
你好。我注册手机号填错了能改吗？	修改账号资料
手机号可以跟改吗？	修改账号资料
修改手机号码	修改账号资料
能不能修改生日	修改账号资料
更换手机号码	修改账号资料
可以修改注册手机号不	修改账号资料
换号了可以改不	修改账号资料
手机号码已经没用了可以修改不	修改账号资料
你好！我填写资料时电话号码填写错了怎么办	修改账号资料
我想更改电话号码	修改账号资料
生日写错了，能改吗	修改账号资料
你好，请问，我可以更换绑定的手机号码	修改账号资料
怎么换手机号	修改账号资料
我换了手机号，能修改吗	修改账号资料
你好，手机号码可以更改吗	修改账号资料
手机号码不用了，好换吗	修改账号资料
你好怎的修改手机号	修改账号资料
我注册电话号填错一个号怎么办	修改账号资料
能跟改手机号码	修改账号资料
手机号码更改	修改账号资料
电话绑错了可以修改吗？	修改账号资料
我能不能换个手机号码	修改账号资料
手机号码可以更改吗	修改账号资料
我的生日写错了	修改账号资料
我的姓名写错了，能修改吗？	修改账号资料
你好请问号码丢了，可不可以换啊	修改账号资料
我怎不能绑我的名字	修改账号资料
我的注册姓名不对	修改账号资料
改资料	修改账号资料
我可以修改电话号码吗	修改账号资料
我账号之前绑的手机号不用了能换不	修改账号资料
你好，我注册手机号码可不可以改呢	修改账号资料
电话填错了可以改吗	修改账号资料
修改生日	修改账号资料
我想修改生日	修改账号资料
我生日错了可以改吗	修改账号资料
我填错生日了	修改账号资料
我当初生日填写错了	修改账号资料
我生日乱填的怎么办	修改账号资料
我想修改生日日期	修改账号资料
生日日期怎么修改	修改账号资料
我想修改生日日期	修改账号资料
我能改生日吗	修改账号资料
我填写生日时点错了怎么办	修改账号资料
我不是那时生日的	修改账号资料
我的生日日期错了	修改账号资料
我生日不是那时候	修改账号资料
在维护吗	系统维护状况说明
工行维护到几点？	系统维护状况说明
支付宝什么时候维护好	系统维护状况说明
维护多久	系统维护状况说明
PT维护多久	系统维护状况说明
忘了登录密码	忘记密码
找回密码	忘记密码
登录密码忘了	忘记密码
登录密码不记得了	忘记密码
你好，我密码找回了，然后官方发给我一个数字密码，我想修改密码，系统提示我旧密码不正确，什么问题？	忘记密码
忘记密码了	忘记密码
登录密码忘记了	忘记密码
我收到的短信新密码不对	忘记密码
你好，登陆密码忘记了	忘记密码
忘记密码了	忘记密码
游戏密码是什么的	忘记密码
我忘记密码了	忘记密码
忘记登录密码	忘记密码
这个账号的密码	忘记密码
密码忘记怎么找回	忘记密码
多次输入错误密码	忘记密码
密码忘了	忘记密码
密码忘记了	忘记密码
我忘记登录密码了	忘记密码
登陆密码忘了	忘记密码
忘记了密码	忘记密码
我的账号密码忘l了	忘记密码
密码多次输错了。解封	忘记密码
密码忘记了	忘记密码
帮我查一下我的密码是多少？	忘记密码
找回登陆密码	忘记密码
收到你们微信注册送132彩金	体验金咨询
注册送8--88元彩金怎么领取	体验金咨询
下载app领取体验金，怎么手机收不到验证码	体验金咨询
可以申请注册送88？	体验金咨询
请问收到邮箱特邀注册送彩金在什么地方领取	体验金咨询
收到邮件注册送68	体验金咨询
收到邮件说注册送59	体验金咨询
收到特邀邮件注册送132	体验金咨询
收到邮件邀请注册送132	体验金咨询
我收到Q箱邀请注册即送132	体验金咨询
你们发我的邮件是讲注册128元彩金	体验金咨询
注册彩金	体验金咨询
领取邮箱邀请132开户彩金	体验金咨询
为什么提示我的资料重复不能领取彩金	体验金咨询
新会员注册有彩金送的吗？	体验金咨询
邮箱邀请注册88彩金	体验金咨询
注册送彩金？	体验金咨询
注册送彩金吗	体验金咨询
注册送彩金吗?	体验金咨询
你好，申请邮件特邀注册彩金38元	体验金咨询
我的注册彩金不送，app下载彩金还是不送？我艹	体验金咨询
注册132的彩金在那领	体验金咨询
你们发的邮件给我说特邀送彩金，是注册就送？	体验金咨询
我收到Q箱邀请注册送132	体验金咨询
注册送彩金吗	体验金咨询
新注册会员有彩金送吗	体验金咨询
你好为什么收不到体验金	体验金咨询
怎么体验金没有	体验金咨询
邮箱给我发来邮件说我注册就送128	体验金咨询
你好，我收到邮件说注册送彩金，不知道在哪里申请	体验金咨询
注册领132你们发邮件给我的	体验金咨询
注册彩金申请	体验金咨询
刚刚注册你们这个游戏，有优惠吗？	体验金咨询
注册送彩金吗？	体验金咨询
注册送132	体验金咨询
微信邀请注册送132	体验金咨询
刚刚接到邮件说可以申请开户彩金	体验金咨询
我想咨询下注册送38	体验金咨询
申请注册彩金	体验金咨询
我邮件收到注册送88元。。有？	体验金咨询
微信接到开户送132怎么没到账啊	体验金咨询
注册账号送彩金吗	体验金咨询
为啥手机不能收不到验证码啊	体验金咨询
手机收不到验证	体验金咨询
手机收不到验证码	体验金咨询
申请注册送132	体验金咨询
注册彩金未领到	体验金咨询
领不到注册彩全	体验金咨询
新人注册彩金	体验金咨询
如何领取体验金要验证码	体验金咨询
邮箱邀请，注册送132	体验金咨询
我邮箱收到特邀消息。注册存款36送88是不是真的？	体验金咨询
你好，我收到邮件说注册送彩金，不知道在哪里申请	体验金咨询
app 下载彩金接收验证码领取，我没收到短信验证码，语音验证码要没有，怎么会事？	体验金咨询
问题是我点了发送验证码但没有验证码发过来	体验金咨询
注册送彩金对吗	体验金咨询
请问新用户注册送彩金吗	体验金咨询
领取注册彩金	体验金咨询
申请注册送彩金	体验金咨询
我收到邮箱注册送88彩金在哪申请啊？	体验金咨询
注册送彩金	体验金咨询
app体验金咋没有了	体验金咨询
注册彩金怎么申请不了？	体验金咨询
为什么我注册了，拒绝我的体验金	体验金咨询
你好？你们这里注册就送礼金是嘛？	体验金咨询
注册彩金88	体验金咨询
新注册几天了还没体验金	体验金咨询
收到邮箱注册送132	体验金咨询
注册就送18彩金吗	体验金咨询
注册送42	体验金咨询
为什么系统显示我已经注册领取彩金	体验金咨询
注册送88彩金吗？	体验金咨询
领注册彩金	体验金咨询
第一次注册不是有彩金送	体验金咨询
申请注册彩金	体验金咨询
注册彩金	体验金咨询
我刚来你家玩，领个体验金还说我账户资讯重复，我梦游时注册过你家的嚒	体验金咨询
说的注册送彩金的呢	体验金咨询
你们发邮件给我，叫我来注册领取88	体验金咨询
收到邮箱注册送88彩金	体验金咨询
收到你们公司发的邮件，注册开户特邀彩金	体验金咨询
现在收到不到检证码怎么搞	体验金咨询
收到邮件说注册找你送18彩金	体验金咨询
我邮件收到一封特邀注册送彩金	体验金咨询
领取注册彩金	体验金咨询
注册送彩金	体验金咨询
申请下载注册彩金	体验金咨询
注册88？	体验金咨询
申请注册彩金	体验金咨询
怎么领取邮箱特邀注册彩金132	体验金咨询
你好我收到邮件说注册送38	体验金咨询
收到邮件说注册送38元彩金	体验金咨询
我下载app了但是没有注册彩金啊	体验金咨询
邮件收到注册送38元	体验金咨询
体验金是要你们人工转下吗	体验金咨询
验证码能不能发到我邮箱	体验金咨询
是注册送128吗	体验金咨询
注册送钱	体验金咨询
申请注册彩金88	体验金咨询
怎么申请开户彩金	体验金咨询
邮箱里收到特邀注册	体验金咨询
注册帐号送88彩金这个活动结束了没有？	体验金咨询
开户送148	体验金咨询
你好怎么领取邮箱特邀注册彩金	体验金咨询
领取邮箱特邀注册彩金132	体验金咨询
开户礼金	体验金咨询
开户彩金	体验金咨询
注册礼金	体验金咨询
注册彩金	体验金咨询
收到邮件注册送38彩金	体验金咨询
注册送彩金	体验金咨询
我收到邮件说注册送88	体验金咨询
开户彩金	体验金咨询
收到特邀注册邮件	体验金咨询
开户送白菜	体验金咨询
我收到邮件注册送128是真的吗？	体验金咨询
我手机号填错了是不是就申请不了注册礼金	体验金咨询
开户彩金	体验金咨询
注册礼金	体验金咨询
领取邮箱邀请注册送132彩金	体验金咨询
为什么我刚注册的号，申请不了彩金啊？说我重复	体验金咨询
新注册用户送体验金，	体验金咨询
请问你们没有反验证码我怎么印证了	体验金咨询
申请注册彩金	体验金咨询
收到邮件申请注册88元彩金	体验金咨询
你好注册送彩金吗	体验金咨询
怎么领取注册彩金	体验金咨询
领取注册彩金	体验金咨询
你好，我邮箱收到邮件注册送36-88是什么意思	体验金咨询
申请邀请注册送26	体验金咨询
注册彩金	体验金咨询
注册送彩金吗	体验金咨询
新注册的是不是送彩金	体验金咨询
我注册账号，怎么还没发彩金呢？	体验金咨询
申请注册彩金	体验金咨询
邮件特邀开户送18彩金找在线客服申请	体验金咨询
注册彩金有没	体验金咨询
注册送彩金吗	体验金咨询
我的注册彩金呢	体验金咨询
我刚刚注册怎么没给彩金	体验金咨询
注册不是送钱吗	体验金咨询
邮件说注册送彩金	体验金咨询
邮件特邀送注册彩金	体验金咨询
邮件特邀开户礼金	体验金咨询
邮件说送我开户礼金	体验金咨询
邮件说开户送彩金	体验金咨询
注册送132	体验金咨询
注册送58	体验金咨询
注册送48	体验金咨询
开户礼金	体验金咨询
开户彩金	体验金咨询
注册礼金	体验金咨询
注册彩金	体验金咨询
提款怎么这么慢	提款相关问题
取款没到账	提款相关问题
取款要多久到账	提款相关问题
我的提款为什么取消	提款相关问题
提款已经审核了，怎么还不放款	提款相关问题
我的取款怎么还没有到账啊？？	提款相关问题
提款没收到。	提款相关问题
提款还没到账。	提款相关问题
我提款	提款相关问题
你那取款的时候出现账号密码	提款相关问题
请问提款一般多长时间到账	提款相关问题
一般审核提款的多长时间	提款相关问题
提款怎么失败了	提款相关问题
之前申请的出款，怎么被取消了	提款相关问题
提款什么时候到账啊？	提款相关问题
什么时候提款到账	提款相关问题
忘记取款问题	提款相关问题
一般提款多久道长啊	提款相关问题
你看一下我的是不是在提款的路上	提款相关问题
请问我的取款何时到账	提款相关问题
取款何时到账	提款相关问题
提款没到账	提款相关问题
提款太慢了	提款相关问题
最低取款是多少	提款相关问题
提款怎么还没到账	提款相关问题
取款干嘛退回	提款相关问题
取款没到账	提款相关问题
没办法提款	提款相关问题
提款不成	提款相关问题
提款不能	提款相关问题
怎么没办法提款	提款相关问题
为什么我提款它审核了。但一直都不执行。我开始提它审核了，但是过了一会又给我提款取消了	提款相关问题
你好我提款怎么取消了呢	提款相关问题
我提款怎么还没有到查查	提款相关问题
取款没到账	提款相关问题
取款没到账	提款相关问题
我要提款先转到那个账户	提款相关问题
最近几天提款老是取消，要提好几次。	提款相关问题
提款页面里的密码是登录游戏密码，还是取款密码	提款相关问题
为什么提款不成功	提款相关问题
我的提款还得审核多久？	提款相关问题
我的提款	提款相关问题
我提款怎么半天不到账	提款相关问题
提款怎么给我取消了	提款相关问题
提款怎么给我取消了，几个意思	提款相关问题
我的提款好久能到账？	提款相关问题
我的提款出款没有？	提款相关问题
还没有出款吗？	提款相关问题
怎么半天了，还没出款	提款相关问题
提款已审核，还没出款？	提款相关问题
提款审核要多久	提款相关问题
客服你好！我刚刚支付宝充值的50块钱怎么还没到账？	提款相关问题
我想提款	提款相关问题
怎么提现？	提款相关问题
提款怎么提不了	提款相关问题
提款没到	提款相关问题
手机号码更换了 能提款吗	提款相关问题
无法提款	提款相关问题
提款到账了吗	提款相关问题
我提款为什么提不出来？	提款相关问题
提款相关信息	提款相关问题
俄的提款怎麼還沒到帳呢	提款相关问题
出款怎么那吗慢	提款相关问题
我的提款为什么还没到账	提款相关问题
你好。问一下，自助金打到多少可以提款？	提款相关问题
我取款了	提款相关问题
提款多久到账	提款相关问题
你好，你们这边提款审核通过后还需要多久到账？	提款相关问题
你好能不能帮我查查我提款怎么一直都是待审核了	提款相关问题
提款要求	提款相关问题
是提款没到	提款相关问题
你好我提款怎么还没到卡上	提款相关问题
为什么出不了款	提款相关问题
我刚刚提款了怎么还没到账	提款相关问题
怎么提现那么久不到的？	提款相关问题
我提款。需要身份证，核实	提款相关问题
提款核实	提款相关问题
亲，麻烦查询下出款都半小时过去了还没到账	提款相关问题
提款不到账	提款相关问题
麻烦看下出款没到账啊？	提款相关问题
提款，显示已审核，但是款没到账	提款相关问题
亲我提款成功这么久了怎么还没有到啊	提款相关问题
不是说秒速提款吗	提款相关问题
提现要什么时候到	提款相关问题
您好，我刚才提款，完成了，想再提款，说我没审核完成	提款相关问题
我提款为什么取消了啊	提款相关问题
提款怎么一直审核状态啊	提款相关问题
提款一直待审核状态	提款相关问题
就是没有到账提款1个多小时了，啥子情况	提款相关问题
亲我提款1多小时了怎么还没到账	提款相关问题
提款没到账	提款相关问题
你好，我是,我想不起来了我的提款密码。麻烦你查一下休改	提款相关问题
存一百送五十那要多少流水可以取款	提款相关问题
你好请问提款初始密码是多少？	提款相关问题
提款已审核了，十多分钟没到帐	提款相关问题
账号，提款怎么一直在审核中啊	提款相关问题
我的提款一直审核中到底咋回事	提款相关问题
账号提款怎么被取消了？	提款相关问题
出款什么老是不批	提款相关问题
您好我的提款怎么取消了？	提款相关问题
提款怎么被取消了	提款相关问题
我提款半小时了怎么还没到账麻烦帮我查一下行吗	提款相关问题
你好提款未到	提款相关问题
我提款，说我登录密码错误	提款相关问题
我明明记得我早上400元，可是提款记录上为什么没有呢！什么原因，另外，400块钱也不见了	提款相关问题
提款都提了快一个小时了还没审核呢。	提款相关问题
刚才出款六百怎么还在审核？？？	提款相关问题
提款不到账	提款相关问题
提款要发邮件油箱号多少	提款相关问题
提款邮箱	提款相关问题
提款邮件发送到哪里	提款相关问题
客服邮箱	提款相关问题
客服邮箱多少	提款相关问题
提款多久到账？	提款相关问题
我一个半小时前提款100元至今未到	提款相关问题
你好提款查询状态	提款相关问题
我提款要审核多久	提款相关问题
提款多久可以到账啊	提款相关问题
提现密码不知道了。怎么办	提款相关问题
怎么我提个230紧在审核啊	提款相关问题
提款多久能到	提款相关问题
提款审核邮箱	提款相关问题
提款邮箱	提款相关问题
审核提款邮箱	提款相关问题
提款邮箱多少	提款相关问题
审核邮箱多少	提款相关问题
审核提款寄哪个邮箱	提款相关问题
提款资料寄哪个邮箱	提款相关问题
提款卡号错了	提款相关问题
用了错误的卡号提款	提款相关问题
提现卡号错误	提款相关问题
提款卡号错误怎么办	提款相关问题
提现卡号错误怎么办	提款相关问题
提款用了错误的卡号	提款相关问题
提款的卡号错误	提款相关问题
你好 帮我查询一下流水	刷新流水
帮我更新一下流水	刷新流水
我的提款流水还差多少	刷新流水
查流水	刷新流水
麻烦帮我更新一下流水	刷新流水
帮我查看我的流水是否达到优惠限制	刷新流水
帮我刷新一下流水	刷新流水
玩了两个小时了，咋没有流水呢	刷新流水
我有多少流水了	刷新流水
客服，请帮我刷新下提款流水。我已经打够了流水，提款还是限制的	刷新流水
怎么显示我流水不够？	刷新流水
pt存送的流水帮我刷新一下	刷新流水
帮我更新PT流水，我要提款	刷新流水
差多少流水	刷新流水
差多少流水户内转账	刷新流水
可以给我刷新一下流水吗	刷新流水
给我刷新一下流水	刷新流水
查流水	刷新流水
我的投注额早就够了，为什么不让转出，	刷新流水
查看流水	刷新流水
请问怎么看流水	刷新流水
给我查一下，流水还差多少	刷新流水
给我查一下，转账流水还差多少	刷新流水
新会员首存有什么活动	首存咨询
邮箱说存100送100，多少流水呢	首存咨询
存100送100？	首存咨询
首充100送100？	首存咨询
首充送100%？	首存咨询
请问申请首存应该怎么弄	首存咨询
首存提款有什么要求	首存咨询
申请的首存提款金额有没有限制	首存咨询
我怎么不能申请首存款优惠呢？	首存咨询
你好问下NT.的游戏，贡多，在首存活动彩金可以游戏吗？算翻倍奖金游戏吗？	首存咨询
我刚注册的号怎么不能申请首存优惠	首存咨询
注册首存百分百的优惠彩金。怎么没有反水的吗	首存咨询
你好，请问首存优惠百分之百自助优惠转账老虎机钱包可以玩pt游戏吗	首存咨询
百家乐有首存优惠码	首存咨询
百家乐可以申请首存优惠吗	首存咨询
百家乐能不能申请首存	首存咨询
请问那个新用户首存赠送多少流水可以下款	首存咨询
首存45元有什么优惠	首存咨询
我是不是申请过首存	首存咨询
帮我查查有没有申请首存	首存咨询
我申请过首存吗	首存咨询
查我有没有用过首存	首存咨询
首存我用过吗	首存咨询
首存我申请过吗	首存咨询
帮我查查有没有申请过首存	首存咨询
首存我有申请过吗	首存咨询
首存我用过吗	首存咨询
我之前绑定的银行卡丢了，现在改怎么重新绑定	密保银行卡解绑
以前的是农业银行的现在新卡也是农业银行的系统说要先解绑以前的我该怎么办	密保银行卡解绑
我想修改银行卡号	密保银行卡解绑
如果银行卡绑不了怎么办	密保银行卡解绑
不支持我银行卡	密保银行卡解绑
提现卡号错误怎么处理	密保银行卡解绑
查下我的卡号	密保银行卡解绑
帮我解绑一下银行卡	密保银行卡解绑
我的卡号填错了	密保银行卡解绑
我的卡号绑错了	密保银行卡解绑
我绑错卡号了	密保银行卡解绑
卡号绑错了	密保银行卡解绑
卡号填错了	密保银行卡解绑
银行卡号填错了	密保银行卡解绑
我刚刚绑错卡了	密保银行卡解绑
我的卡号没用了要解绑	密保银行卡解绑
我要解绑卡号	密保银行卡解绑
怎么解绑卡号	密保银行卡解绑
请问救援金发放没有	救援金咨询
救援金怎么没派发呢？	救援金咨询
我昨天的救援金呢？	救援金咨询
救援金怎么这么慢	救援金咨询
今天的救援金怎么还不派发	救援金咨询
怎么没有救援	救援金咨询
救援金怎么还不到	救援金咨询
你妈了逼你们根据什么返还救援金	救援金咨询
救援金	救援金咨询
你好，账号申请救援金	救援金咨询
怎么不给救援金	救援金咨询
申请救援金	救援金咨询
救援金申请不了	救援金咨询
救援金什么时间发放	救援金咨询
你好你们给我发邮件说给我红包	红包咨询
我站内信收到的红包错误的	红包咨询
给个转运红包	红包咨询
邮箱收到信息特邀送彩金	红包咨询
刚刚接到客服电话说我有个红包领取是在哪里领取啊	红包咨询
申请短信特邀58	红包咨询
申请手机收到特邀存30送59	红包咨询
帮我查下我有没有什么红包可以领	红包咨询
有没有红包领	红包咨询
帮忙看一下我有红包没有用的	红包咨询
一个红包都不给我，输死	红包咨询
申请转运红包	红包咨询
转运红包	红包咨询
可不可以送红包给我啊	红包咨询
如何获得红包优惠券	红包咨询
转运金	红包咨询
申请转运彩金	红包咨询
申请邮件特邀彩金18元	红包咨询
领取18元红包	红包咨询
收到手机短信特邀领取活跃彩金	红包咨询
网银转账有红包吗	红包咨询
申请一下转运红包	红包咨询
手机收到特邀	红包咨询
说网站有活动有红包领，却不知道在哪里领？	红包咨询
为什么我没有红包优惠卷啊	红包咨询
你好，帮我申请一下转运红包	红包咨询
你好，收到短信特邀42彩金	红包咨询
刚刚七夕一个红包优惠券代码我没复制过来，怎么才能领	红包咨询
申请的转运金呢？	红包咨询
申请转运红包	红包咨询
怎么今天情人节都没有红包送呢？其它的平台都有呢。	红包咨询
我刚看到你们给我游戏里发的邮件说可以领红包	红包咨询
短信通知我领一红包，怎么还没有	红包咨询
申请转运红包	红包咨询
收到手机短信特邀领取活跃彩金	红包咨询
申请转运红包	红包咨询
申请特邀彩金	红包咨询
收到邮箱特邀 说领取38彩金	红包咨询
申请转运红包	红包咨询
你好，这个红包优惠券说使用过，咋回事	红包咨询
我看邮箱，说特邀领取132彩金，	红包咨询
你好，收到你们的特邀邮件	红包咨询
奖励个转运红包三	红包咨询
申请的红包优惠88代码不对	红包咨询
红包在哪里领取，打电话说的。我有个红包没领	红包咨询
怎么抢红包	红包咨询
红包码不见了	红包咨询
我是邮件特邀	红包咨询
尊宝国际从来没有送过送过红包优惠券在QQ邮件里面也没有收到红包代码是否可以考虑一下	红包咨询
你们给我申请的红包呢	红包咨询
收到你们发的特邀邮件	红包咨询
 我申请的转运红包，怎么没有	红包咨询
申请特邀彩金	红包咨询
好(✪▽✪)，收到特邀彩金	红包咨询
我邮箱收到邮件说有特邀彩金赠送请问是真的吗	红包咨询
客服你好～请问那个邮箱特邀的他显示叫我联系在线客服领取的	红包咨询
邮箱特邀送30	红包咨询
红包优惠代码显示错误。	红包咨询
红包优惠券	红包咨询
送一张红包优惠券	红包咨询
申请邮箱特邀彩金…	红包咨询
申请红包优惠券	红包咨询
充了100多，发个红包	红包咨询
申请邮箱彩金	红包咨询
怎么我的红包优惠卷错误	红包咨询
红包优惠券代码	红包咨询
使用优惠券之后额度不见了误？	红包咨询
存送/红包优惠卷	红包咨询
为什么红包优惠卷告诉我代码错误？	红包咨询
说我红包有人用啦	红包咨询
我红包码给我发的，领取不了，	红包咨询
申请红包优惠券	红包咨询
红包优惠券代码..	红包咨询
红包微信	红包咨询
特邀彩金132	红包咨询
你好收到邮件特邀存款50送50	红包咨询
我说尊敬的客服，才说送的红包怎么没有没有啊	红包咨询
有特邀送彩金？我要申请	红包咨询
申请红包	红包咨询
为什么我的优惠代码是错的	红包咨询
领取电话特邀红包	红包咨询
申请转运红包	红包咨询
这么久了，什么时候送个免费的红包卷？	红包咨询
有没有免费的红包	红包咨询
咨询收到短信 领取5--588红包怎么领取	红包咨询
我的优惠券无法使用	红包咨询
我领到的优惠券怎不能用	红包咨询
我邮件收到优惠券不能用	红包咨询
申请转运红包	红包咨询
为什么我的优惠红包还没有派发？	红包咨询
我有一个特邀彩金68	红包咨询
我操，一个红包，审核两天。真他妈的人才	红包咨询
领取电话通知红包	红包咨询
我申请的转运红包呢	红包咨询
我怎么邀请朋友呢	好友推荐
我邀请我的朋友注册，用什么邀请呢	好友推荐
推见会员有红利么	好友推荐
推荐好友怎么弄	好友推荐
我邀请朋友	好友推荐
邀请好友	好友推荐
怎么邀请好友	好友推荐
我找我朋友玩有啥好处	好友推荐
我怎么找我朋友玩	好友推荐
如何邀请好友	好友推荐
邀请好友给奖励吗	好友推荐
邀请好友给红包吗	好友推荐
推荐好友有礼金吗	好友推荐
我推荐了好几个人来玩	好友推荐
我找了很多朋友来玩	好友推荐
我怎么申请推荐好友奖励	好友推荐
推荐朋友玩有红包吗	好友推荐
我邀请好友了 红包呢	好友推荐
我邀请好友的彩金呢	好友推荐
我推荐我朋友来玩有奖金吗	好友推荐
我找了朋友来玩 给点回馈吧	好友推荐
我推荐了好多朋友来玩 不给点奖励说不过去吧	好友推荐
好友礼金怎么申请	好友推荐
推荐好友奖励在哪	好友推荐
我推荐朋友有啥奖励	好友推荐
我想申请你家代理	官网及账号问题
注册不了	官网及账号问题
告你电子邮箱格式不对咋回事	官网及账号问题
为什么我注册不了账号	官网及账号问题
注册登录送128	官网及账号问题
我忘记我注册的帐号密码了	官网及账号问题
我的专客服微信是多	官网及账号问题
专属客服	官网及账号问题
怎做代理	官网及账号问题
有没有需要合作	官网及账号问题
帐号注册问题	官网及账号问题
无法注册	官网及账号问题
我注册好了，但不能登录	官网及账号问题
我要重新注册	官网及账号问题
能查注册时间吗	官网及账号问题
我的专属客服是谁	官网及账号问题
专属客服在哪	官网及账号问题
我想做你们的代理	官网及账号问题
麻烦你把你们的代理主管QQ发我谢谢	官网及账号问题
代理怎么算佣金的	官网及账号问题
不能发送截图吗	官网及账号问题
无法截图	官网及账号问题
提款需发送邮件核实邮箱多少	官网及账号问题
提款叫我发邮件，邮箱号多少	官网及账号问题
我怎么注册不了啊	官网及账号问题
账号怎么注册	官网及账号问题
没法注册	官网及账号问题
怎么截图，我不会	官网及账号问题
怎么截图你教我	官网及账号问题
请问这个号码是什么时候注册的	官网及账号问题
我想咨询这个号码是什么时候注册的	官网及账号问题
请问我做代理，今天又给我发了个账号，什么意思	官网及账号问题
帮我查下我的账号注册日	官网及账号问题
如何查询账号几月几日注册的	官网及账号问题
我注册有一年了吗？	官网及账号问题
微信专员微信号	官网及账号问题
请问需要做推广吗	官网及账号问题
你给我的qq是真的吗	官网及账号问题
品牌高效推广方式供您选择：1.网络广告：APP广告直投+3000家网站投放（每天充值8个以上）2.【苹果推信】：iMessage精准高端客户，92%以上到达率.4.【苹果商城】：APPStore，精准优化排名推广5.短信群发：精准客户资源，转化率高，实时发送！6贴吧论坛：(2000多家权重贴吧，红名置顶)需要联系推广妹子QQ：2543866401	官网及账号问题
你好，【新渠道银联短信卡发，银联短信卡发，银联短信卡发，】实时发送，内容不限，20字以内都可以。需要了解直接联系我专员QQ：3273342885(可提供测试)	官网及账号问题
你好，我的专属客服是多少号	官网及账号问题
您好，有需要第三方支付请联系我（微信扫码支付宝H5，QQ,银联，网银D0结算，秒到）平台稳定，资金安全联系QQ:657461904	官网及账号问题
有微信客服吗	官网及账号问题
我微信被清理好友，把你们微信专员删除了，你们微信专员微信号多少？	官网及账号问题
注销什么？我说微信专员微信号多少？	官网及账号问题
微信专员	官网及账号问题
我这边账号注册不了	官网及账号问题
有微信客服嘛	官网及账号问题
微信专员不说话	官网及账号问题
我的微信专属客服多少	官网及账号问题
这个帐号微信专属客服多少	官网及账号问题
我怎么没有专属客服	官网及账号问题
帮我查一下我的专属客服多少呢	官网及账号问题
特邀的微信号怎么不回复的	官网及账号问题
账户微信客服是谁呀！	官网及账号问题
是注册就送128吗	官网及账号问题
我加微信客服他不理我	官网及账号问题
我找我专属客服	官网及账号问题
我想查我的注册时间	官网及账号问题
怎么不能截图	官网及账号问题
手机要怎么截图	官网及账号问题
怎么截图我不会	官网及账号问题
手机要怎么截图	官网及账号问题
代理	官网及账号问题
在哪里看注册时间	官网及账号问题
帐号注册问题	官网及账号问题
官网及账号注册问题	官网及账号问题
58同城定向包月广告位，找你们广告负责人联系方式谈合作	官网及账号问题
你好，广告推广需要吗？1.直播推广2.网站劫持3.苹果推信4.邮件群发5.网页投放联系QQ3002919680	官网及账号问题
你们平台微信客服	官网及账号问题
你好，微信客服要我重新注册，用户名不能用	官网及账号问题
怎么截图	官网及账号问题
怎么发截图	官网及账号问题
我从哪截图	官网及账号问题
我不会截图	官网及账号问题
截图怎么发	官网及账号问题
我想截图不会	官网及账号问题
我用手机不会截图	官网及账号问题
我电脑不会截图	官网及账号问题
我不能截图	官网及账号问题
我截图发不出去	官网及账号问题
告诉我怎么截图	官网及账号问题
我跟你说我不会截图	官网及账号问题
截图在手机上	官网及账号问题
我不能截图	官网及账号问题
怎么才能截图	官网及账号问题
截图到哪里截图阿	官网及账号问题
我怎么截图阿	官网及账号问题
我怎么才截图阿	官网及账号问题
截图 不会	官网及账号问题
没办法截图	官网及账号问题
你教我截图	官网及账号问题
告诉我如何截图	官网及账号问题
无法注册、不能注册	官网及账号问题
我注册不了	官网及账号问题
我没办法注册	官网及账号问题
我不能注册	官网及账号问题
不能注册怎办	官网及账号问题
怎么不能注册	官网及账号问题
为啥不能注册	官网及账号问题
开个号怎不行	官网及账号问题
办个账号失败	官网及账号问题
我想开号怎么不能	官网及账号问题
我想注册不能用	官网及账号问题
一直注册不了	官网及账号问题
要注册搞不好	官网及账号问题
注册不了你给我弄	官网及账号问题
帮我注册行不	官网及账号问题
我不会注册 弄不了	官网及账号问题
你那注册都都弄不起来	官网及账号问题
查询注册时间	官网及账号问题
我啥时注册的	官网及账号问题
我啥时开户的	官网及账号问题
查询开户时间	官网及账号问题
我什么时候开户的	官网及账号问题
我什么时候注册的	官网及账号问题
我那时注册的	官网及账号问题
我哪时开户的	官网及账号问题
怎么看我啥时注册的	官网及账号问题
我注册多久了?	官网及账号问题
告诉我我注册多久了	官网及账号问题
我几时注册的	官网及账号问题
我开户多久了	官网及账号问题
我在这玩多久了	官网及账号问题
我啥时在这开始玩的	官网及账号问题
查下我注册多久了	官网及账号问题
我都开户多久了，你查下	官网及账号问题
帮我查下我的注册时间	官网及账号问题
我几号注册的	官网及账号问题
我几月几号注册的	官网及账号问题
帮我查下我的开户时间	官网及账号问题
昨天投注没有返水，现在能不能	返水咨询
我这账号百家乐反水是多少	返水咨询
bb电子游戏投注反水怎么申请	返水咨询
我账号怎么洗不了码	返水咨询
你们不是打电话给我说我账号有反水？在哪	返水咨询
百家乐反水	返水咨询
帮我查下自助反水领不了了	返水咨询
我的反水呢	返水咨询
昨天晚上玩的游戏咋没反水？	返水咨询
帮我刷新哈反水	返水咨询
刷新哈自助反水	返水咨询
你好自助洗码不成功	返水咨询
几点反水	返水咨询
刚玩了pt怎么没有洗码	返水咨询
自助反水反不了	返水咨询
系统反水没添加	返水咨询
几点反水	返水咨询
查询一下我的洗码！！！	返水咨询
帮我把反水刷新一下自助反水	返水咨询
自助打码，	返水咨询
我的时时还水怎么不行	返水咨询
昨天晚上玩的游戏咋没反水？	返水咨询
返水不正确	返水咨询
我微信存了钱怎么没到账了	存款相关问题
存款问题	存款相关问题
我用支付宝转梅二亮的一百块还没到帐	存款相关问题
支付宝转账怎么没到账	存款相关问题
怎么我的存款没有显示	存款相关问题
支付宝转帐没到帐	存款相关问题
支付宝转帐没到帐	存款相关问题
微信转了100咋不到账	存款相关问题
你好，我刚刚用支付宝转账，已经成功到账，为什么我的账号里没有钱	存款相关问题
刚刚支付宝转账的充值没有到账	存款相关问题
网银存款怎么还没到账	存款相关问题
支持花呗存款吗	存款相关问题
支付宝没有到账	存款相关问题
我的存款不见了	存款相关问题
秒存30支付宝没有到账	存款相关问题
存款没到账	存款相关问题
怎么存款还没到账户	存款相关问题
存款还没到账快点	存款相关问题
没办法存	存款相关问题
不能存款	存款相关问题
怎么我的存款还不到账	存款相关问题
充值还没到账	存款相关问题
查一下存款	存款相关问题
存款没到帐	存款相关问题
麻烦处理下存款	存款相关问题
无法充值	存款相关问题
刚支付宝上分还没到账	存款相关问题
存款没到账	存款相关问题
存款怎么迟迟没到账	存款相关问题
存款没有到账	存款相关问题
刚微信存款100没到账	存款相关问题
存款没有到账	存款相关问题
存款问题	存款相关问题
你好，你们这个存款怎么会存了少掉	存款相关问题
充值没到账	存款相关问题
存款没到账	存款相关问题
存款成功没有到账	存款相关问题
为什么微信支付300到账只有287	存款相关问题
昨晚存款是点错了只存了13元怎么还没到账	存款相关问题
亲，我网银转账为什么还没处理呢	存款相关问题
你好麻烦你帮我查一下存款没有到账，谢谢	存款相关问题
你好我问下支付宝存款是转到支付宝账号还是转到银行卡	存款相关问题
昨天我银行转账到现在都没到	存款相关问题
存款不到	存款相关问题
存款不对	存款相关问题
银联支付	存款相关问题
支付宝转账	存款相关问题
支付宝扫码	存款相关问题
我充值了，账户上没有钱	存款相关问题
为什么最低存款500元	存款相关问题
为什么最低存款要500	存款相关问题
我存的钱为什么没有到	存款相关问题
充值100没到账	存款相关问题
我的钱已经转过去了没到账	存款相关问题
存款没到账	存款相关问题
刚才存款忘记写存款人了	存款相关问题
存款时没写存款人姓名	存款相关问题
你们公司支持花呗充值不？	存款相关问题
你们这个存钱在哪里存	存款相关问题
支付宝扫一扫存款什么时候到账	存款相关问题
我充值了，怎么还没有到账	存款相关问题
会员充值没到账	存款相关问题
存款没有到账	存款相关问题
存款怎么延迟	存款相关问题
你好刚刚我支付宝转账20怎么还没到	存款相关问题
支付宝转账30，没到	存款相关问题
你家支付宝转账存款那个青岛银行到账那么慢呢	存款相关问题
银联扫码付款200没到账	存款相关问题
美女我存一百，怎么只有95.50	存款相关问题
存款未到	存款相关问题
钱充丢了	存款相关问题
请问充值成功没到账	存款相关问题
存款成功没得账	存款相关问题
我存款成功没到账	存款相关问题
微信扫码不能支付了	存款相关问题
我的支付宝转账怎么用不了？	存款相关问题
我支付宝充值活跃不足是什么意思	存款相关问题
什么是活跃	存款相关问题
不需要存款吗	存款相关问题
怎么微信充值还没到	存款相关问题
怎么微信充值没到账	存款相关问题
什么是活跃	存款相关问题
尼玛还得活跃不足	存款相关问题
存款没有到账	存款相关问题
支付宝扫码存款未到账	存款相关问题
活跃怎么又不	存款相关问题
存款不到账	存款相关问题
活跃怎么又不租	存款相关问题
充值还没到账	存款相关问题
刚刚我支付宝转10块怎么还没到	存款相关问题
我刚支付宝扫码支付1000没到账……	存款相关问题
刚刚用支付宝存300，没到账	存款相关问题
怎么我存款还没到账	存款相关问题
存款问题	存款相关问题
存款没有到账	存款相关问题
支付宝aop在线支付宝的	存款相关问题
微信充值多久到	存款相关问题
微信不可以冲5？	存款相关问题
支付宝转账没有到帐	存款相关问题
微信支付不能存200吗	存款相关问题
微信能支付200吗	存款相关问题
取消微信	存款相关问题
存款的钱不对	存款相关问题
存款没到	存款相关问题
存款没到账	存款相关问题
微信不可以充值50？	存款相关问题
微信有没有小额支付啊？	存款相关问题
麻烦把活跃度弄下	存款相关问题
支付宝存款，活跃度不够	存款相关问题
存款不到账	存款相关问题
怎么用快捷支付充值	存款相关问题
存款到账没	存款相关问题
存款没到账	存款相关问题
你好，客服，刚才我支付宝转账40元，没到我的账户	存款相关问题
页面怎么没有存钱的页面	存款相关问题
我要能扫码的支付宝不要转帐	存款相关问题
我半小时用支付宝转账存款怎么还没有到账户	存款相关问题
支付宝转账成功游戏没有到账	存款相关问题
怎么我支付宝转账成功了，怎么还没到账	存款相关问题
支付宝转账成功游戏没有到账	存款相关问题
支付宝转账怎么那么久	存款相关问题
我充值100元，为什么到账只有95.5	存款相关问题
请问我要存款进来，咋弄啊。	存款相关问题
存款还没到账	存款相关问题
支付宝存款没有到账	存款相关问题
充钱怎么那么久不到的·？	存款相关问题
昨天晚上充值没有到	存款相关问题
发下银行卡号存款	存款相关问题
你好.怎么到帐这么慢呢	存款相关问题
支付宝存款没有到账	存款相关问题
存款未到帐	存款相关问题
我刚刚充值500半天没到账	存款相关问题
存上钱了，怎么还没到账	存款相关问题
你好我提的款怎么还没到卡上喃	存款相关问题
存款没到账啊。服了	存款相关问题
存款已经完成，还没到账号	存款相关问题
支付宝存款到了为什么还没来？	存款相关问题
支付宝转账怎么还没到帐	存款相关问题
刚才用支付宝转账50没收到，请查一下	存款相关问题
存款不到账	存款相关问题
我支付了什么没到账？	存款相关问题
支付宝转钱没收到，请查一下	存款相关问题
存款没到	存款相关问题
支付宝转账怎么这么长时间还不到账呢？	存款相关问题
查收存款	存款相关问题
存款没到帐	存款相关问题
客服我刚支付宝转钱40元，怎么还没到账？	存款相关问题
我刚才微信存款500元为什么还没到账	存款相关问题
支付宝转账怎么没到	存款相关问题
充值没到账	存款相关问题
亲，我的存款怎么还没到账？	存款相关问题
你好，我刚存了款。麻烦查一下	存款相关问题
存款那久还不到	存款相关问题
我的存款怎么一直没到账？	存款相关问题
存款能快点》?	存款相关问题
刚刚用支付宝转账怎么还没到帐	存款相关问题
我怎么存款还没到	存款相关问题
可以用花呗充值吗？	存款相关问题
存款未到帐查询了吗	存款相关问题
充值没到	存款相关问题
在线支付	存款相关问题
怎么存款？	存款相关问题
存款了100没有到账。	存款相关问题
为什么我手机转款已经成功了，但是没有到账	存款相关问题
为啥微信不能存款	存款相关问题
支付宝存款未到账	存款相关问题
存款问题	存款相关问题
充值没到账	存款相关问题
麻烦帮我处理下我的存款	存款相关问题
你好 存款188没有到账 	存款相关问题
存款没到账..	存款相关问题
充值没到账	存款相关问题
支付宝没有到账	存款相关问题
我都等了20多分钟了，存的钱到底到不到啊	存款相关问题
等了20多分钟了，存的钱到底到不到啊	存款相关问题
支付宝扫码支付未到账	存款相关问题
我咋冲的钱还没到啊	存款相关问题
账号存不上钱	存款相关问题
微信存款	存款相关问题
存款没有到账	存款相关问题
我16号有一笔存款转账成功没有到账户	存款相关问题
能不能用支付宝花呗付款	存款相关问题
银联支付还没到账	存款相关问题
我支付宝转帐到帐子怎么还没显示出？	存款相关问题
UST币怎么往游戏撑	存款相关问题
充钱后到账能不能快一点？	存款相关问题
附言存款未到账，银行显示已到账	存款相关问题
入款没有到账	存款相关问题
支付宝转账还没到账呢	存款相关问题
我的存款怎么还没到账	存款相关问题
我用支付宝转的钱 还没到账  是不是到账了 我这边才有钱	存款相关问题
现在存钱怎么存不了，你们给的账号是错的	存款相关问题
你们存款账号是错的	存款相关问题
我用支付宝转的钱  都半个小时了  怎么还不到账	存款相关问题
你好我刚存款怎没有了	存款相关问题
微信支付需要手续费了	存款相关问题
有没有其它用微信支付的方式	存款相关问题
微信转账怎么做	存款相关问题
存款未收到	存款相关问题
存款金额少了	存款相关问题
支付宝扫码没有到账	存款相关问题
支付宝扫码没有到	存款相关问题
如何存款	存款相关问题
哪里存款	存款相关问题
为什么要收手续费	存款相关问题
你们怎么可以收我手续费	存款相关问题
存款没有到账	存款相关问题
我刚刚存款忘了打附言	存款相关问题
存款没到	存款相关问题
充值咋还没到	存款相关问题
支付宝充值成功没到账	存款相关问题
支付宝充值50怎么没到账	存款相关问题
z支付宝转账成功怎么钱没到	存款相关问题
请请帮我查一下，一笔支付宝转账还未到账。	存款相关问题
充值500怎么没到帐了	存款相关问题
如何存款	存款相关问题
充钱冲不进去	存款相关问题
手续费是什么	存款相关问题
为什么要手续费	存款相关问题
啥是手续费	存款相关问题
手续费多少	存款相关问题
存款收什么手续费	存款相关问题
最低存款多少啊	存款相关问题
最低存款	存款相关问题
最低存款门槛	存款相关问题
存款最低多少啊	存款相关问题
多少最低存款	存款相关问题
存款一次存多少	存款相关问题
微信存款最低多少	存款相关问题
支付宝存款最低多少	存款相关问题
网银存款最低多少	存款相关问题
你好我怎么才能领取次次存优惠呢？	次存咨询
我不太会玩，咨询下怎么杨才能领取次次存优惠	次存咨询
我想咨询次次优惠怎么领取	次存咨询
你好，为什么笔笔存送只能要十次而已吗？	次存咨询
笔笔存	次存咨询
我要申请次存咋又转不了账了呢	次存咨询
账目查询	查询账号状态
查询总存款	查询账号状态
查总存款	查询账号状态
查总提款	查询账号状态
我要查我的总存款	查询账号状态
查下我注册到现在的输赢	查询账号状态
查询下我的总存款	查询账号状态
查询下我的总提款	查询账号状态
我到现在提款多少了?	查询账号状态
我到现在存款多少了?	查询账号状态
我总共存过多少钱	查询账号状态
我总共提款过多少钱	查询账号状态
查下我的输赢	查询账号状态
我存过多少钱	查询账号状态
我出过多少钱了	查询账号状态
我下过多少分	查询账号状态
我上过多少分了	查询账号状态
我就是用的谷歌浏览器	不能登录
app怎么登陆不了	不能登录
登陆不了	不能登录
pt怎不能登了	不能登录
我不能登入pt啊	不能登录
我下载好了。登陆显示请检查您的网络	不能登录
你好！PT客户端怎么进不去了？	不能登录
网站多少	不能登录
pt不能登了	不能登录
怎不能登录	不能登录
网站告诉我	不能登录
网站告诉我	不能登录
网站是什么？	不能登录
APP更新为什么帐号登录不了	不能登录
官网不能登录	不能登录
电脑网进游戏网址发个	不能登录
我刚注册的帐号登不上名字陈小虎	不能登录
亲，麻烦给我个手机网址嘛，谢谢！	不能登录
用那个浏览器好点	不能登录
为什么手机平台登陆老是错误？	不能登录
用电脑登录你们网址是好多	不能登录
平台网站多少	不能登录
网址多少	不能登录
发网止	不能登录
把网止发过来	不能登录
把尊宝网止发过来	不能登录
尊宝国际网止多少	不能登录
我下的app怎么都有问题，登陆都登不了	不能登录
不能登录了	不能登录
官网不能登录	不能登录
我app登录不进去	不能登录
游戏怎么登陆啊！没有登陆的那个	不能登录
网址多少？	不能登录
电脑用什么网址	不能登录
电脑版网址	不能登录
网址是啥？	不能登录
APP怎么登录不了账户	不能登录
账号密码不能登入	不能登录
来个电脑端网址	不能登录
pt不能登了	不能登录
尊宝国际的网址是	不能登录
游戏网站	不能登录
网站	不能登录
要个电脑版官网链接	不能登录
我pt下载了登不上	不能登录
pt怎么不能登啊	不能登录
下载pt不能进去	不能登录
下载pt不能登阿	不能登录
pt游戏不能登阿	不能登录
dt下载完不能登	不能登录
pt下载完不能登	不能登录
dt怎么不能登阿	不能登录
怎么没有生日礼包呀	VIP咨询
领取生日礼金	VIP咨询
申请生日礼金	VIP咨询
是不是只要投注额达到10就可以成青铜vip？？	VIP咨询
我这个月生日，请问，我是否可以申请生日礼金呢？	VIP咨询
我生日礼金，在怎么取不出来啊	VIP咨询
我马上过生日了，有没红包领取啊	VIP咨询
您好，可以申请免费筹码吗我	VIP咨询
申请生日采金	VIP咨询
app 登录不了	app咨询
请问我申请下载APP彩金，为什么说我信息重复。。不可能	app咨询
注册下载app送彩金？	app咨询
app哪里下载	app咨询
我用APP登录的时候老是提示请检查我的网络	app咨询
app下载怎么没送彩金	app咨询
我下载好了APP不是自己进去申请不了彩金么	app咨询
我是领取app彩金领取的彩金我要转到mg是PT	app咨询
APP连不上	app咨询
手机pt客户端下载链接	app咨询
你们这个pt客户端更新以后登录就特别难	app咨询
发个尊宝下载地址给我	app咨询
把pt客户端给我发一下，手机版的	app咨询
把PT客户端网址给我发	app咨询
我申请APP下载领彩金	app咨询
我怎么没有APP彩金	app咨询
我下载App了为什么不送彩金	app咨询
我下载app没有礼金啊	app咨询
麻烦发个下载APP的链接给我	app咨询
你好，我是要分享APP的链接让我朋友下载啊	app咨询
pt客户端怎么下载不了	app咨询
有没有PT客户端	app咨询
刚刚注册账号不是下载APP给彩金吗	app咨询
下载官网APPA	app咨询
下载久安app彩金	app咨询
你好，下午APP客户端怎么下载的，	app咨询
请你把PT客户端下载方式发给我一下	app咨询
老子要PT客户端	app咨询
给我个安卓pt	app咨询
pt客户端	app咨询
下载PT客户端x	app咨询
下载PT客户端链接给我发一下	app咨询
下载手机APP彩金多少可以提款	app咨询
我下载好了APP怎么领取啊	app咨询
我申请下载APP彩金，怎么提示我已经申请过了啊	app咨询
为什么我app发送的验证手机收不到呢？	app咨询
那下载app的彩金怎么不给	app咨询
app无法下载	app咨询
下载手机APP就送彩金吗？	app咨询
下载不了APP	app咨询
你好领取的下载APP金可以玩什么	app咨询
为什么PT客户端下载了没办法更新啊？？	app咨询
我需要PT游戏的新版本下载网址	app咨询
PT游戏下载	app咨询
申请APP彩金	app咨询
手机下载ａｐｐ　送８８彩金好久到账呀？	app咨询
把你们App下载网址发我	app咨询
申请APP注册彩金	app咨询
我新注册的账号app也下载了怎么可以得到奖励金	app咨询
怎么下载APP	app咨询
无法领取APP下载彩金呢	app咨询
怎么下载app	app咨询
苹果版app	app咨询
无法领取下载金	app咨询
你好我下载app怎么领取彩金？收不到验证	app咨询
我是新注册客户又下载了手机App，申请彩金	app咨询
申请下载APP彩金	app咨询
下载APP彩金什么时候到账	app咨询
你好我己下载ApP是不是要送彩金	app咨询
你好我领取了下载APP的12彩金，要打到多少才可以提款	app咨询
APP彩金怎么领取	app咨询
特邀下载app送彩金	app咨询
为什么pt客户端不能用了	app咨询
领取的app彩金可以玩pt的日日生财游戏吗	app咨询
我怎么申请不了下载APP的彩金	app咨询
你好。怎么说我信息重复呢？不能申请APP彩金？	app咨询
发个手机pT客户端	app咨询
在哪里领取下载彩金？	app咨询
下载app彩金在哪里领取	app咨询
下载PT客户端在哪下	app咨询
一登录p丅客户端加什么字母	app咨询
请帮我查询一下我的账号还能不能申请下载app送12-88的优惠彩金	app咨询
请问PT手机端登陆前面加什魔	app咨询
你好我申请APP红包	app咨询
我下载了APP也绑定银行卡了怎么领取APP彩金呢？	app咨询
我用手机申请app彩金不让填写行吗	app咨询
app下载不了亚	app咨询
app怎么下载	app咨询
下载app怎么领取彩金啊	app咨询
下载app需要验证手机号码	app咨询
下载客户端在哪里	app咨询
你好，pt客户端下载网址多少？	app咨询
申请下载APP优惠彩金	app咨询
客户端怎下载	app咨询
我下载app了没给我红包啊	app咨询
申请手机APP优惠	app咨询
PT客户端上不去了	app咨询
我下载了APP怎么领彩金	app咨询
dt下载完打不开	app咨询
pt下载完打不开啊	app咨询