问题	备注
怎么不能去App彩金	app咨询
为什么我申请不了APP礼金	app咨询
怎么我下载手机APP怎么领不了彩金	app咨询
你好，手机APP怎么不能下载啊	app咨询
PT客户端，为什么总提示我账户名或密码错误	app咨询
我刚注册的，APP彩金为什么不能领取啊	app咨询
我下载了app为什么领不到彩金	app咨询
怎么申请不了下载app彩金	app咨询
我刚刚APP下载了，如何得到彩金？	app咨询
苹果APP下载？	app咨询
下载APP有彩金吗	app咨询
APP彩金怎么没到呢	app咨询
app彩金是领取还是自动送	app咨询
领不了下载彩金呢	app咨询
我领下载app彩金，说我资料更复	app咨询
申请app下载彩金怎么收不到验证码啊	app咨询
下载app给彩金吗	app咨询
给我手机上发一个app的验证吗	app咨询
我申请APP彩金现在收不到验证码啊？	app咨询
怎么下载啊	app咨询
请问Pt客户端账号密码多少	app咨询
为啥我下客户端下不了	app咨询
app下载地址	app咨询
客户端登录前加	app咨询
下载的app彩金提示我信息重复没有给我	app咨询
客户端在哪里下载	app咨询
给个pt下载连接	app咨询
我登录不了pt客户端	app咨询
app彩金只能玩老虎机?	app咨询
pt客服端怎么下不起，登录pt客服端加不加字母？	app咨询
APP下载网址	app咨询
亲手机下载网址是多少	app咨询
客服端要加那个字母	app咨询
苹果下载网址	app咨询
PT客户端，为什么总提示我账户名或密码错误	app咨询
APP彩金不能领取。	app咨询
为什么我申请不了APP礼金	app咨询
怎么不能去App彩金	app咨询
vip筹吗什么时候可以呀什么	VIP咨询
vip福利不能领？	VIP咨询
免费筹码什么时候可以领	VIP咨询
你查询一下我账户还差多少晋级	VIP咨询
vip筹码领不了	VIP咨询
领取vip每月的送的钱	VIP咨询
你好可以申请免费筹吗	VIP咨询
vip每月免费筹码，怎么领不了？	VIP咨询
免费筹码还不可以领吗？	VIP咨询
申请生日彩金	VIP咨询
vip领取彩金怎么领不了	VIP咨询
我可以申请生日礼金吗？	VIP咨询
申请免费筹码	VIP咨询
为什么没有vip奖金呢	VIP咨询
免费筹码什么时候才可以开始领？	VIP咨询
vip免费筹码什么可以领取	VIP咨询
vlp免费筹码怎么申请	VIP咨询
vip免费筹码怎么领不了	VIP咨询
怎么领取vip每月的奖励领取不了呢？	VIP咨询
免费筹码什么时候可以领	VIP咨询
我怎么没有免费筹码	VIP咨询
领取免费筹码	VIP咨询
怎么免费筹码领取不到	VIP咨询
这个月没有vip免费筹码吗	VIP咨询
领取生日彩金	VIP咨询
VIP 免费彩金怎么领不了呢	VIP咨询
请问Vip免费筹码好久能领取？	VIP咨询
vip礼金几号可以领啊	VIP咨询
我要晋级怎么说我流水不够	VIP咨询
自助晋级	VIP咨询
自助晋级	VIP咨询
投注额10万VIP可以升级是吗	VIP咨询
自助晋级	VIP咨询
vip免费筹码怎么不能领？	VIP咨询
vip福利不能领？	VIP咨询
自助晋级	VIP咨询
你查询一下我账户还差多少晋级	VIP咨询
vip筹吗什么时候可以呀什么	VIP咨询
免费筹码什么时候可以领	VIP咨询
vip筹码领不了	VIP咨询
电脑登网址是多少	不能登录
给我一个电脑登陆网址	不能登录
把网址发过来	不能登录
电脑版本的最新网址多少	不能登录
那网址是多少	不能登录
网站多少	不能登录
网站多少？	不能登录
客户端解锁	不能登录
你好，我的网址被劫持了	不能登录
给几个备用网址	不能登录
网站好多	不能登录
你好我的论坛怎么登陆不上去	不能登录
电脑网址是什么	不能登录
登录链接	不能登录
账户清单页面	查询账号状态
次次存不能玩那些游戏啊？	次存咨询
刚才微信充值没到账	存款相关问题
我支付宝转的钱快一个小时了，还没到游戏账号上？	存款相关问题
我支付宝转账的存款，还没到账呢！	存款相关问题
怎么我微信入款半小时了还没到帐？	存款相关问题
微信有快捷存款存一百要收手续费？	存款相关问题
充上钱了、沒到帐	存款相关问题
存款迟迟未到帐	存款相关问题
云闪付转账到银行卡50没有到	存款相关问题
我刚存了一百元还没到账	存款相关问题
没到账怎么回事支付宝	存款相关问题
我微信转账怎么还没到账呢？	存款相关问题
存款咋没到账	存款相关问题
我充值为啥说活跃不足？	存款相关问题
什么情况、又没到账	存款相关问题
微信从值没到账	存款相关问题
存款未到账	存款相关问题
帮我看一下怎么还没有到账	存款相关问题
支付宝转账怎么没到账	存款相关问题
存款方式存款方式有什么有什么	存款相关问题
微信转不了账	存款相关问题
不能存款吗	存款相关问题
我存100怎么只有98	存款相关问题
存款没到 银联扫码	存款相关问题
存款已经到账，但是你们不上分你们干鸡毛呢	存款相关问题
怎么还没到	存款相关问题
帮我看下到帐没	存款相关问题
久安充值成功，没有上账	存款相关问题
我都转账成功了怎么还没到账	存款相关问题
我的充值不进账啊	存款相关问题
我充值成功，没有上账	存款相关问题
你好我的存款还没到账了	存款相关问题
存款五百没有到账	存款相关问题
怎么支付宝转账这么慢	存款相关问题
请问你我用微信支付充了五百这么还没有到呢	存款相关问题
支付宝扫码存款没有到账	存款相关问题
微信不能充值	存款相关问题
银联扫码没有到账	存款相关问题
支付宝扫码冲100到多少	存款相关问题
我存的钱哪去了	存款相关问题
你好，我的存款怎么没有到账啊	存款相关问题
请问目前可以使用微信扫码	存款相关问题
请问下，我支付宝充值都到账了，怎么号上紧到余额不到账了	存款相关问题
充值怎么没到账	存款相关问题
帮我把订单取消一下谢谢	存款相关问题
我刚用云闪付扫码存款100没有到账	存款相关问题
到账成功怎么账户没钱	存款相关问题
我支付宝转账了还没到账，就100	存款相关问题
银联扫码充值没有到账，刚才找客服了的	存款相关问题
银联扫码为什么要手续费	存款相关问题
云闪付充值成功，没有上账	存款相关问题
你好怎么我存款20多分钟了还没有	存款相关问题
存款六百没到	存款相关问题
为什么我冲了500元，到账只有495	存款相关问题
京东支付	存款相关问题
微信扫码	存款相关问题
久安钱包	存款相关问题
快捷支付	存款相关问题
通过银联转账，交易结束了还没到账，都还没到呀	存款相关问题
支付宝转账	存款相关问题
银联支付	存款相关问题
支付宝扫码	存款相关问题
在线支付	存款相关问题
怎么我微信入款半小时了还没到帐？	存款相关问题
支付宝转账，查清楚了吗？	存款相关问题
我昨天存款	存款相关问题
我看账户清单里存款附言记录显示我存的50未处理	存款相关问题
今天上不了分	存款相关问题
微信有快捷存款存一百要收手续费？	存款相关问题
我支付宝转的钱快一个小时了，还没到游戏账号上？	存款相关问题
存款没到账sini888	存款相关问题
支付宝转账，还没到帐，太慢了	存款相关问题
刚微信存款100没到账	存款相关问题
我提款后洗码怎么没有投注记录了	返水咨询
昨天的返水什么时候到账？	返水咨询
怎么前天存款了没返水	返水咨询
我在12点之前的那个反水他什么时候返给我。	返水咨询
为什么我的帐号没有反水呢？	返水咨询
为什么实时反水领不到	返水咨询
BBIN有没有反水？	返水咨询
申请实时反水	返水咨询
自助反水怎么没有	返水咨询
下载Aqq	app咨询
领App下载彩金	app咨询
我下载了app，，怎么申请彩金	app咨询
pt客户端下载	app咨询
我今天下载的这个app注册的它为什么说我资料重复呢	app咨询
我的qt客户端登录密码不对	app咨询
你好，我想下载APP可提示用苹果或者安卓系统打开是什么意思	app咨询
我下载APP扫完二维码提示用苹果或者安卓设备打开是什么意思	app咨询
我下载PT客户端在手机	app咨询
我下载APP扫完二维码提示请用苹果或者安卓设备打开。是什么意思	app咨询
下载APP是不是送彩金	app咨询
APP下载领彩金怎么领不了呢？	app咨询
申请下载app彩金	app咨询
我的下载app彩金什么时候到	app咨询
PT平客户端又打不开	app咨询
申请下载APP彩金	app咨询
申请APP彩金	app咨询
APP彩金多少提现	app咨询
下载app有没有彩金送？	app咨询
现在注册下载app就有优惠是吗	app咨询
一开始是不是我总投注到了3500就可以晋级了。？	VIP咨询
我的投注到多少的时候可以自助晋级！？	VIP咨询
会员礼金怎么申请	VIP咨询
VIP晋级	VIP咨询
申请生日彩金	VIP咨询
最新网址多少	不能登录
手机浏览器怎么进不去呢	不能登录
登录不了	不能登录
怎么登陆不上	不能登录
登陆不上	不能登录
手机板网址发过来	不能登录
你好我的论坛怎么登陆不上去	不能登录
电脑登陆网址是多少？	不能登录
打不开，跳到其他网站了	不能登录
查询账目	查询账号状态
怎么看我的帐户	查询账号状态
就是说查看我的帐户	查询账号状态
查询帐号状态	查询账号状态
昨天晚上12__1点存款时系统做维护，不能申请次存优惠。请问现在可以申请吗？	次存咨询
次存优惠	次存咨询
申请次存	次存咨询
我存款没到	存款相关问题
怎么存款呀我	存款相关问题
怎么说我支付被限额阿	存款相关问题
又说我活跃度不够	存款相关问题
帮我取消威信秒存订单	存款相关问题
怎么我存款100只到账98	存款相关问题
我说这到账金额不对呀	存款相关问题
存款好久还不到账	存款相关问题
存款没到账	存款相关问题
存款好久怎么还不到账	存款相关问题
存款没到账	存款相关问题
支付宝转账10分钟还没到账怎么办	存款相关问题
刚才充了10元怎么没有	存款相关问题
是转账显示成功，游戏里却未到账	存款相关问题
你好，00:45充值没到账	存款相关问题
你好，在线充值成功，未到账	存款相关问题
我存款怎么没到账	存款相关问题
我刚充值的100元怎么还没到账	存款相关问题
充值没到账	存款相关问题
账户充值这么久时间都没到账呢	存款相关问题
存款未及时到账	存款相关问题
我是咋天的17:03用手机银行给支付的，昨天我也给客服反映过了，到现在还没到帐	存款相关问题
发错了-，我是存款末到帐	存款相关问题
点卡能充值吗	存款相关问题
曲世鑫，帐号是青岛银行：8022102009153012018/08/08 19：03:21 是网银实时汇款￥53元我情况也已纪反映了几遍了，到现在还没刻账	存款相关问题
刚刚微信扫码100元，怎么没到账啊？	存款相关问题
存款没到	存款相关问题
看看我的存款	存款相关问题
我存款怎么没到	存款相关问题
我的存款没有到账	存款相关问题
我存款没到账	存款相关问题
我存款怎么没到	存款相关问题
请问微信怎么存款	存款相关问题
存款没到账	存款相关问题
银联扫码未到账	存款相关问题
我刚才存款掉单了	存款相关问题
存款没到帐	存款相关问题
充值没到帐	存款相关问题
支付宝20没到账	存款相关问题
存款没有到账	存款相关问题
刚才手机银行存款到现在还没到帐	存款相关问题
存款没到账	存款相关问题
我钱上了还没有到账	存款相关问题
你好，支付宝在线充值10多分钟了还没到账	存款相关问题
存款未到的？	存款相关问题
取消微信	存款相关问题
怎麽存	存款相关问题
存款金额不对	存款相关问题
微信扫码支付成功，游戏里没有到账	存款相关问题
支付宝充值没到账	存款相关问题
存30到账29.14怎么办？优惠活动不能申请	存款相关问题
您好，支付宝充值，没到账	存款相关问题
支付宝转账还没到账啊	存款相关问题
存30到账29怎么办理优惠	存款相关问题
我存款30只到账29	存款相关问题
支付宝转转现在还没有到	存款相关问题
如何户内转账.10元钱怎么还没有给我上账号上呢？	存款相关问题
我用支付宝已付款怎么还没有分	存款相关问题
你好我存款了2500元，为什么没有给我添加啊	存款相关问题
我刚才存款30元，未到账	存款相关问题
支付宝扫码未到账	存款相关问题
你们平台怎么回事我存的钱怎么这么长时间了也没到帐呢	存款相关问题
不到账啊？多久能到	存款相关问题
充值什么时候能到账？	存款相关问题
活跃度不足是什么意思	存款相关问题
充值找谁啊？	存款相关问题
存钱很慢吗这里	存款相关问题
存款还没有到账	存款相关问题
我刚冲的钱怎么没到账的	存款相关问题
钱转过去了没到账	存款相关问题
存款没到账	存款相关问题
刚刚微信存款500了怎么还不到账啊	存款相关问题
我存的款已经到账了，分怎么还没有	存款相关问题
微信存款怎么存	存款相关问题
请问我存的款怎么还没到啊？	存款相关问题
您好，我的充值没到帐，找客服陈述了N遍，就没了消息，我该找谁	存款相关问题
凌晨入款网上银行在线支付转账成功。打电话给银行证实钱早已放对方账户， 可为什么你们一直办理不好，	存款相关问题
我存款没有到账	存款相关问题
没办法存款	存款相关问题
没法存款	存款相关问题
微信存款怎么存	存款相关问题
刚刚微信扫了100没到账哟？	存款相关问题
自助洗码	返水咨询
自助返水	返水咨询
之前的返水怎么没了	返水咨询
bbin没自助反水吗	返水咨询
专属客服在那里	官网及账号问题
我不记得我的代理账号了	官网及账号问题
怎样注册	官网及账号问题
怎么注册	官网及账号问题
注册不可以啊	官网及账号问题
注册出现用户名重复	官网及账号问题
您好！请问贵公司需要做广告推广吗？	官网及账号问题
需求有实力有实力的菠菜平台长期合作劫持流量，可以先测试，再合作。有意向可以加qQQ：5189213	官网及账号问题
代理佣金计算	官网及账号问题
您好，我们这边是支付通道这一块的，包括微信，支付宝，网银等，有需要可以联系我们	官网及账号问题
还在为推广发愁吗？还在为没人注册发愁吗？想日注册破百吗？想会员不断吗？想轻轻松松做起大盘吗？你需要一份针对性的博彩数据，一手玩家数据。有实力的老板。欢迎前来测试。、请加QQ：1423957764	官网及账号问题
下午好，老板！请问贵公司有需要做广告推广吗？	官网及账号问题
账户注册问题	官网及账号问题
注册帐号无法注册	官网及账号问题
我推荐我朋有来玩了，有什么彩金吗	好友推荐
我说我推荐我朋友来玩	好友推荐
申请红包	红包咨询
我的红包优惠券喃	红包咨询
申请转运红包	红包咨询
转运红包	红包咨询
给我发邮件特邀送132彩金了	红包咨询
你好，我可以申请个红包么。存款那么多，一次都没下过钱	红包咨询
不是说送我一个红包吗	红包咨询
申请特邀彩金	红包咨询
还可以帮我申请一个红包吗	红包咨询
请帮我申请转运红包	红包咨询
存送/红包优惠卷	红包咨询
申请个转运红包	红包咨询
红包优惠券	红包咨询
存送/红包优惠卷	红包咨询
我收到信息叫我加zunbao04这微信有五个红包	红包咨询
尼玛我的左右红包还没给	红包咨询
操你妈你问他我的专用红包给没给	红包咨询
凭邮箱特邀可以领取132注册彩金吗	红包咨询
申请转运红包	红包咨询
红包在哪里	红包咨询
申请转运包	红包咨询
我的红包卷找谁领	红包咨询
帮我申请个转运红包	红包咨询
邮件特邀如何申请	红包咨询
领取红包	红包咨询
百分百存送卷是多少倍流水	红包咨询
申请转运包	红包咨询
我想申请个红包	红包咨询
我收到信息叫我 加zunbao04这微信有五个红包	红包咨询
凭邮箱特邀可以领取132彩金吗	红包咨询
请问下救援金是不是还没有发放	救援金咨询
秘密秘密保是啥	密保银行卡解绑
解綁銀行卡	密保银行卡解绑
我绑卡怎么弄	密保银行卡解绑
怎么绑卡	密保银行卡解绑
帮我解绑一下银行卡	密保银行卡解绑
首存啦	首存咨询
你好，首充有什么优惠送啊，谢谢	首存咨询
刚首存了请查询	首存咨询
为什么我不能自助申请pt首存款优惠呢？	首存咨询
请问一下，我领了老虎机的首存是不是就不可以领PT的	首存咨询
帮我刷一下流水	刷新流水
查PT流水转账	刷新流水
麻烦你帮我看一下PT里面还差多少流水可以转账	刷新流水
帮我查一下PT里还差多少流水可以转账	刷新流水
给我刷新下流水	刷新流水
为什么我的PT账户还不能转账呢？流水够了啊	刷新流水
可以看一下怎么流水不对	刷新流水
流水多少?	刷新流水
您目前存在流水限制PT无法转账	刷新流水
流水不会自动更新吗	刷新流水
我的提款啦	提款相关问题
我的提款呜呜呜	提款相关问题
但怎么提款啊	提款相关问题
不能提	提款相关问题
我说不能提款	提款相关问题
提款怎么提	提款相关问题
提款给我取消了？	提款相关问题
帮我查询一下我的提款进度	提款相关问题
取款没到账	提款相关问题
查询出款没有到账	提款相关问题
怎么今天提款这么慢	提款相关问题
怎么今天提款这么慢	提款相关问题
怎么审核了不放款	提款相关问题
为什么提款还没到账	提款相关问题
你好，我提款为什么上面一直显示已审核，就是没有显示已执行？	提款相关问题
提款为什么取消？	提款相关问题
怎么我提款还没到账	提款相关问题
你好，提款没到账	提款相关问题
我账户上面提款，为什么审核通过后却给我取消提现了呢	提款相关问题
提不了款	提款相关问题
你好，麻烦你提款催一下好吗	提款相关问题
提款未到帐	提款相关问题
一般提款要多少时间到账？	提款相关问题
提款需要多久	提款相关问题
提款一直待审核	提款相关问题
提款怎么还没有到账呢？	提款相关问题
查查我的出款怎么还没有到账	提款相关问题
怎么提款了已审核好久到账哦	提款相关问题
提款一直是审核中	提款相关问题
提款怎么还没到账	提款相关问题
提款多长时间到账呢	提款相关问题
我提款成功了，怎么还没到账	提款相关问题
取款没到账，咋回事	提款相关问题
怎么提款一直是待审核	提款相关问题
怎么提款一直是待审核	提款相关问题
你好，提款怎么还没审核完？	提款相关问题
提现出问题	提款相关问题
提现不到	提款相关问题
那我怎么提现，我现在要给钱人家	提款相关问题
提款怎么还在审核	提款相关问题
提款已审核，怎么还不执行？	提款相关问题
取款处理下	提款相关问题
提款怎么还没有到账哦？	提款相关问题
我六合彩中奖了提现不到。说要一倍流水。我冲二千多下了一千左右。我现在要给钱人家怎么办	提款相关问题
体验金给我	体验金咨询
请问下载彩金怎么收不到短信	体验金咨询
申请注册彩金	体验金咨询
不能领体验金	体验金咨询
彩金申请注册	体验金咨询
注册送132彩金？	体验金咨询
我刚申请了个新号，送的彩金在什么地方可以玩	体验金咨询
8-88彩金	体验金咨询
注册送体验金吗？	体验金咨询
8-88	体验金咨询
领起体验金	体验金咨询
注册会员有将金么	体验金咨询
是不是注册就送132元哦	体验金咨询
注册送彩金	体验金咨询
你好收到邮件注册送彩金	体验金咨询
注册是不是送132	体验金咨询
你们给我发了邮箱说注册就送88了体检金是不是真了	体验金咨询
你们发了邮箱说注册就送88	体验金咨询
收到邮件，开户送132	体验金咨询
请问注册送132彩金是吗？	体验金咨询
新用户注册送彩金么	体验金咨询
你好，我呢体验金怎么不可以领	体验金咨询
你好，我收到邮件，注册送88元吗？	体验金咨询
体验金有什么要求的	体验金咨询
不是注册给送38彩金啊	体验金咨询
注册彩金	体验金咨询
注册就送彩金吗？	体验金咨询
还是没收到验证码	体验金咨询
是开户就送138吗	体验金咨询
体验出款有什么要求	体验金咨询
我密码突然忘记了	忘记密码
密码忘记了	忘记密码
密码忘了	忘记密码
我密码忘了	忘记密码
登不上，忘了登入密码	忘记密码
我要找回密码发送我邮箱里怎么没有啊	忘记密码
输了错了密码	忘记密码
我密码输错多次了	忘记密码
密码错误被锁请解锁	忘记密码
系统维护	系统维护状况说明
系统维护	系统维护状况说明
维护吗	系统维护状况说明
我注册电话号码写错了	修改账号资料
我手机号码换了，以前那个不用了，可以改吗？	修改账号资料
账号手机号码绑定错误	修改账号资料
修改手机号码	修改账号资料
如何綁定姓名	修改账号资料
咋个修改个人资料	修改账号资料
申请彩金无法输入名字	修改账号资料
我的名字在哪里绑定啊	修改账号资料
pT不能玩	游戏进不去
登录不进去？	游戏进不去
pt游戏怎么进不去了	游戏进不去
mg电子加载不进去是怎么回事	游戏进不去
PT游戏无法登陆	游戏进不去
我把钱转进PT里面之后玩不了游戏啊	游戏进不去
为什么不能游戏	游戏进不去
pt客户端加哪个字母	游戏咨询
PT客户端账号前面需要加什么字母	游戏咨询
手机pt平台加什么字母	游戏咨询
怎么我看朋友圈有人玩三倍猴子	游戏咨询
请问一下彩票北京赛车最多可以下注几个数	游戏咨询
在那里查投注记录啊	游戏咨询
有六合彩吗	游戏咨询
你那里有六合彩吗	游戏咨询
有彩票吗	游戏咨询
妹妹pt客户端加什么字母？	游戏咨询
游戏咨询	游戏咨询
我想查询老虎机游戏	游戏咨询
怎么查询老虎机游戏	游戏咨询
有没有棋牌游戏	游戏咨询
平台激活怎么办	游戏咨询
不是让平台激活吗	游戏咨询
我是六合彩的怎么要下一倍有点难啊。	游戏咨询
pt前面加什么	游戏咨询
你好 mg平台的多旋转游戏指的哪些？	游戏咨询
怎么解冻	账号解锁、忘记账号
忘了账号	账号解锁、忘记账号
解冻账号	账号解锁、忘记账号
忘记帐号	账号解锁、忘记账号
pt账户错误	账号解锁、忘记账号
帮我解锁好吗	账号解锁、忘记账号
我忘记登录帐号	账号解锁、忘记账号
我账号被锁住了	账号解锁、忘记账号
我账号忘记了如何找回	账号解锁、忘记账号
我刚刚注册完就把账户给忘了怎么找回	账号解锁、忘记账号
忘记账号了	账号解锁、忘记账号
忘记登录账号	账号解锁、忘记账号
我lD号多少没见到	账号解锁、忘记账号
怎么冻了我帐号	账号解锁、忘记账号
slot是什么意思	转账咨询
咋不让往游戏里转钱	转账咨询
你好着Sw的游戏是转到什么游戏	转账咨询
户内转账出错	转账咨询
slot是什么啊？	转账咨询
怎么AG额度转换不了	转账咨询
slot是老虎机的什么游戏？	转账咨询
slot是什么啊？	转账咨询
我往棋牌转账转不了	转账咨询
刚充值怎么往棋牌转账	转账咨询
转户余额怎么转到开元棋牌	转账咨询
户内转账	转账咨询
充30送20的活动还在不在	咨询当下相关活动
有什么好玩的活动	咨询当下相关活动
我存了300多红包卷领了当时没复制成功怎么办	咨询当下相关活动
你好，请问你们存100送138的活动还有吗	咨询当下相关活动
你们给我发送qq邮件问我在吗，送我48彩金属实吗	咨询当下相关活动
签到奖金提款	咨询当下相关活动
申请存款彩金	咨询当下相关活动
存款彩金	咨询当下相关活动
我要申请存款彩金	咨询当下相关活动
下载久安app送彩金	咨询当下相关活动
为什么我用手机签到奖金没翻倍啊	咨询当下相关活动
为什么我用手机签到奖金没翻倍	咨询当下相关活动
签到奖金	咨询当下相关活动
申请充值1000送88红包	咨询当下相关活动
钱存入账户选30送21的进不去	咨询当下相关活动
操你妈，申请奖金	咨询当下相关活动
七夕那个怎么领取	咨询当下相关活动
申请尊宝千百倍	咨询当下相关活动
至尊千百倍申请	咨询当下相关活动
申请彩金	咨询当下相关活动
申请千百倍彩金	咨询当下相关活动
申请存款红包	咨询当下相关活动
充值红包	咨询当下相关活动
久安存款送红包	咨询当下相关活动
领取存款红包	咨询当下相关活动
充值红包	咨询当下相关活动
今天的优惠	咨询当下相关活动
签到	咨询当下相关活动
七夕的活动什么时候开始？荷花	咨询当下相关活动
申请支付宝存100送8活动	咨询当下相关活动
你好存送优惠怎样申请	咨询当下相关活动
申请那个存款送红包	咨询当下相关活动
活动要求赠送金额流水限制平台限制 历史存款累积满500（包含5k)以上用户存200送18元存1000送88元5倍老虎机任意平台 未达要求且新注册用户存100送8元 存1000送38元5倍老虎机任意平台	咨询当下相关活动
申请存钱送彩金	咨询当下相关活动
签到的彩金怎么领出进入游戏	咨询当下相关活动
存够三百。领红包	咨询当下相关活动
我申请30送21的优惠	咨询当下相关活动
存款奖励	咨询当下相关活动
我要申请充100送8块的活动	咨询当下相关活动
申请彩金	咨询当下相关活动
申请全部彩金	咨询当下相关活动
领取不了优惠彩金	咨询当下相关活动
你好，签到红包怎么用	咨询当下相关活动
你好，微信客服说我有个什么彩金没有领取	咨询当下相关活动
充值就送活动	咨询当下相关活动
签到彩金规则怎么用	咨询当下相关活动
pt有没有百倍奖彩金领？	咨询当下相关活动
存200送18申请	咨询当下相关活动
存200送18的优惠	咨询当下相关活动
你好我今天的存款加赠彩金怎么还没有送啊？	咨询当下相关活动
存款多少才可以领取签到彩金	咨询当下相关活动
当月存款多少才可以领取签到彩金	咨询当下相关活动
申请亏损彩金	咨询当下相关活动
下载APP送彩金	app咨询
下载APP彩金	app咨询
下载APP彩金	app咨询
下载APP彩金	app咨询
请问Pt客户端账号密码多少	app咨询
下载的app彩金提示我信息重复没有给我	app咨询
我想问的是手机下载app的彩金	app咨询
PT客户端账号密码忘了怎么办	app咨询
手机APP下载地址	app咨询
我下载Aqq送的怎么没到帐了	app咨询
下载APP了解	app咨询
客户端打不开	app咨询
电脑版PT客户端怎么下载啊	app咨询
下载APP送彩金吗	app咨询
APP在那里下载	app咨询
pt客户端下载链接	app咨询
PT客户端下载	app咨询
pt下载链接	app咨询
你好给我个电脑下载的链接吧	app咨询
尊宝平台现在电脑客户端下载不了了吗	app咨询
如何领取生日礼金	VIP咨询
生日彩金没领怎么办	VIP咨询
我申请vip生日礼金	VIP咨询
申请领取vip生日礼金	VIP咨询
我出门了，耽误了领取生日彩金，还能领取吗？	VIP咨询
请问如何申请生日彩金	VIP咨询
有生日彩金送吗	VIP咨询
没收到晋级礼金	VIP咨询
申请会员周年彩金	VIP咨询
你们的网站	不能登录
你好，我的网址被劫持了	不能登录
官网多少	不能登录
你好我的论坛怎么登陆不上去	不能登录
怎么不能登录	不能登录
官方网址多少	不能登录
谷歌也登陆不上去	不能登录
下载网址给我呗	不能登录
总存款多少	查询账号状态
查看我的状态	查询账号状态
存款未到帐	存款相关问题
存款未到帐	存款相关问题
我的存款怎么还未到账	存款相关问题
我存100怎么只有98	存款相关问题
存款没到账	存款相关问题
我要存款	存款相关问题
存款没到帐	存款相关问题
存款没到	存款相关问题
存款没到账	存款相关问题
存款没到账	存款相关问题
未到账	存款相关问题
怎么存款呀	存款相关问题
dfj971215存款处理下什么情况呢	存款相关问题
那你们有哪些存款方式	存款相关问题
久安是啥	存款相关问题
久安钱包是什么东西	存款相关问题
我只有花呗怎么办	存款相关问题
返水不到账	存款相关问题
不是啊!!我支付被限额了	存款相关问题
存款问题	存款相关问题
存100怎么没到	存款相关问题
存款没到帐	存款相关问题
存款不到账	存款相关问题
存款不到账	存款相关问题
我得存款没上分	存款相关问题
充值未到帐	存款相关问题
存款没到账	存款相关问题
存款不到账	存款相关问题
存款怎么还没到账	存款相关问题
存款没有到	存款相关问题
我存款怎么还没到	存款相关问题
未到账	存款相关问题
支付宝扫码	存款相关问题
微信转账	存款相关问题
微信扫码	存款相关问题
我qq支付20怎么没到	存款相关问题
我的存款不到账	存款相关问题
转账未到账请您查询一下谢谢	存款相关问题
怎么钱转不了 到真入娱乐BBIN账号呢	存款相关问题
存款没有到账啊	存款相关问题
怎么存取钱	存款相关问题
我的支付宝转账成功了，钱还没到游戏账户呢	存款相关问题
存款未到帳	存款相关问题
存款109未到账	存款相关问题
怎么存钱	存款相关问题
存款没到账	存款相关问题
我刚才的存款怎么没进去账号里啊	存款相关问题
我存款30元。为什么到账不是30	存款相关问题
注册了不i会存取钱	存款相关问题
存款到账金额不对	存款相关问题
到账金额不对	存款相关问题
我充值30元，为什么到账28.9我现在这么参加30送21	存款相关问题
存不进去钱玩不了，求助	存款相关问题
为什么存款不到账好	存款相关问题
久安钱包怎么支付不了？	存款相关问题
扫码支付的	存款相关问题
什么是活跃度不足	存款相关问题
充值显示不出来	存款相关问题
我用支付宝充的钱怎么还没到账	存款相关问题
支付宝app没有到账	存款相关问题
存的钱没到账	存款相关问题
我二个小时支付宝充值二百，怎么到这时还没到账？	存款相关问题
我存钱一小时还没到账	存款相关问题
你好，怎么冲不了呀	存款相关问题
怎么充值不了呀	存款相关问题
冲值不了	存款相关问题
冲值不了	存款相关问题
存款没到账	存款相关问题
存款沒到	存款相关问题
我的存款怎么还没到	存款相关问题
怎么现在不能充值吗？	存款相关问题
支付宝没到账	存款相关问题
什么是活跃度不足	存款相关问题
支付宝存50元！怎么还没到帐	存款相关问题
你好我充值了30元钱怎么转不到游戏钱包了	存款相关问题
我的微信存款怎么没有到	存款相关问题
存款109未到账	存款相关问题
我转账了怎么还没到账	存款相关问题
存的钱没到账	存款相关问题
冲值不了	存款相关问题
存款一百没到账	存款相关问题
我的存款没到	存款相关问题
支付宝扫码没到账	存款相关问题
在线支付30元成功，怎么我游戏账号上一直没到账？	存款相关问题
存款没到	存款相关问题
我充值了没有到账	存款相关问题
wo我存款31怎么没有分呀	存款相关问题
我的账户刚转了500，核实一下	存款相关问题
银联扫码没到账	存款相关问题
充值未到账	存款相关问题
您好，刚刚我用云闪付存款没到账	存款相关问题
充值不到帐	存款相关问题
刚刚存款没有到账	存款相关问题
我刚刚通过QQ支付了40元怎么没到账	存款相关问题
银行入款怎么入	存款相关问题
青岛银行怎么转账的？开户行是什么	存款相关问题
我要充钱	存款相关问题
你银行账号关了	存款相关问题
银行入款在吗存	存款相关问题
存款没到账	存款相关问题
我支付宝转账成功了为啥还未到账	存款相关问题
我今天网银转账存了200	存款相关问题
我是用支付宝转账的，存款没到账	存款相关问题
支付宝转账，未到账	存款相关问题
我现在想用微信充值可以冲不	存款相关问题
为什么存款那么久还没到账？	存款相关问题
我的微信存款怎么没有到	存款相关问题
无法自助返水，提示上一笔正在审核中，请协助处理	返水咨询
PT无法自助返水，提示无投注记录	返水咨询
返水怎么没有了	返水咨询
看一下反水怎么不对	返水咨询
百家乐几点反水	返水咨询
bbin电子，难道没有反水吗？	返水咨询
你好！我的PT自助返水刷新	返水咨询
游戏返水没记录	返水咨询
怎么一直没反水?	返水咨询
没办法自助反水	返水咨询
我想问哈，为啥我现在自助返水那么慢	返水咨询
游戏没有反水吗	返水咨询
我的反水呢	返水咨询
怎没反水	返水咨询
投注额不更新	返水咨询
请问怎么没有返水呢	返水咨询
请您给帮个忙怎么熊领取返水	返水咨询
怎么看注册时间？	官网及账号问题
能不能查查我什么时候注册的	官网及账号问题
我要找人工客服	官网及账号问题
我找客服	官网及账号问题
查询专属客服是	官网及账号问题
你好啊,这个是要怎么注册啊	官网及账号问题
我注册那个邮箱怎么填呢	官网及账号问题
找客服	官网及账号问题
怎么代理	官网及账号问题
代理流水多少	官网及账号问题
我想重新注册	官网及账号问题
我们这边有良好的QQ号可以提供 广告	官网及账号问题
怎么注册	官网及账号问题
如合开户	官网及账号问题
开新账号	官网及账号问题
怎么注册	官网及账号问题
注册不了	官网及账号问题
注册不了	官网及账号问题
我何时注册的	官网及账号问题
高效广告推广渠道1.直播推广（大流量主播在线专场推广宣传）2.短信群发{引进先进国际平台】0085三网通发}3.邮件群发（带有后台操作，可指定地区人群发送）4.苹果推信发送苹果手机用户，成功率100%三高人群发送需要推广请咨询推广专员QQ1131052294微信yueguang5586（直播推广）	官网及账号问题
账号已存在	官网及账号问题
提示手机号已存在	官网及账号问题
提示手机号已存在	官网及账号问题
崇开帐号	官网及账号问题
重新创建帐号	官网及账号问题
再申请账号	官网及账号问题
再申请账号	官网及账号问题
账号已存在	官网及账号问题
你好！代理在哪里登录	官网及账号问题
微信客服	官网及账号问题
我的接到电话你们客服说给彩金	官网及账号问题
你们客服打电话给我说让我加她qq，给我送彩金，结果加了没反应	官网及账号问题
我是你们特邀会员	官网及账号问题
还在为推广发愁吗？还在为没人注册发愁吗？想日注册破百吗？想会员不断吗？想轻轻松松做起大盘吗？你需要一份针对性的博彩数据，一手玩家数据。有实力的老板。欢迎前来测试。、请加QQ：1423957764	官网及账号问题
客服妹妹呢	官网及账号问题
我可以在哪里看到账号啥时注册的	官网及账号问题
我可以在哪里看到账号啥时注册的?	官网及账号问题
人工客服	官网及账号问题
人工服务有没有？	官网及账号问题
转接人工服务	官网及账号问题
我要找人工客服	官网及账号问题
有人工客服吗	官网及账号问题
有人工客服在吗	官网及账号问题
现在有人工客服在线吗	官网及账号问题
我啥时注册	官网及账号问题
我的客服可以找吗	官网及账号问题
代理都不在的吗	官网及账号问题
QQ或者微信在线客服怎么添加	官网及账号问题
您好请问贵公司需要推广吗？	官网及账号问题
你好，打个电话给我。	官网及账号问题
手机号码被注册	官网及账号问题
申请转运包yff2789	红包咨询
申请个转运红包qqbb3344	红包咨询
领取红包代码	红包咨询
转运红包什么时候到账	红包咨询
n你好，系统怎么显示我的红包代码不对	红包咨询
领取红包代码	红包咨询
申请转运包	红包咨询
我的红包呢	红包咨询
申请转运红包	红包咨询
红包呢	红包咨询
申请转运红包	红包咨询
我是郵箱特遙送彩金	红包咨询
我申请救援基金	救援金咨询
怎么绑定不了银行卡，选择不了银行卡的类型	密保银行卡解绑
绑定银行卡银行	密保银行卡解绑
解绑银行卡	密保银行卡解绑
为什么我的号不能解绑	密保银行卡解绑
银行卡加不上	密保银行卡解绑
请问如何查看自己绑定的什么银行	密保银行卡解绑
抱歉，您不能自助SLOT首存优惠	首存咨询
首存100%	首存咨询
请问一下、刚才收到邮件可以冲200送200，请问一下流水要求？谢谢	首存咨询
流水更新一下	刷新流水
查看流水yg200291	刷新流水
你好，收到你们特邀邮件存50送68存100送136请问需要多少流水	刷新流水
在哪里查看流水	刷新流水
帮我更新一下我的投注流水额度	刷新流水
帮我更新一下我的投注流水额度	刷新流水
查看流水	刷新流水
查看投注流水	刷新流水
帮我查下我今天所有平台的流水	刷新流水
刷新我pt流水	刷新流水
帮我查下我刚刚打的流水有多少	刷新流水
请问一下我还差多少流水可以提款	刷新流水
请问我哪个游戏流水没完成呢？	刷新流水
帮我看看还差多少流水提款	刷新流水
短信邀请50到账118彩金几倍流水	刷新流水
帮我刷新下老虎机的流水	刷新流水
你好，怎么一直提示有流水限制，投注额一直是200多，麻烦给查询一下，谢谢	刷新流水
查PT流水转账	刷新流水
你好，请问我的提款早都已经审核完毕为什么却还没到账？	提款相关问题
你好，请问我的提款早都已经审核完毕了为什么却还没到账呢？	提款相关问题
查下提款，账号siyi880	提款相关问题
提款不到账	提款相关问题
提款没到啊	提款相关问题
怎么提不了款？	提款相关问题
提款没到帐	提款相关问题
提款没到帐	提款相关问题
提款咋没到	提款相关问题
查询下提款怎么还没到	提款相关问题
为什么我提款不到账	提款相关问题
怎么我的取款还没到账	提款相关问题
怎么我的取款还没到账呢	提款相关问题
提款条件	提款相关问题
dfj971215取款处理下	提款相关问题
取款查询	提款相关问题
为什么我不可以提现	提款相关问题
提现被取消	提款相关问题
提现被取消	提款相关问题
取款处理下	提款相关问题
提款咋不到账	提款相关问题
提款没到	提款相关问题
提款一小时还未到账	提款相关问题
一般提款600未到账	提款相关问题
为什么提款取消	提款相关问题
怎么出款这么久还没在帐	提款相关问题
你好，怎么出款出不了	提款相关问题
提款沒到賬	提款相关问题
提款一小时还未到账	提款相关问题
我要提款怎么改提款金额	提款相关问题
我怎么改提款金额	提款相关问题
我的提款怎么被取消了早上	提款相关问题
你们这里最低取款是多少	提款相关问题
查下提款	提款相关问题
我的账号怎么在出款的时候怎么显示密码错误	提款相关问题
我刚刚提款400元怎么还不到账	提款相关问题
提现怎么还没有到账呢	提款相关问题
我提款为啥填写不了钱数呢	提款相关问题
提款多久能到账	提款相关问题
为什么取消我的取款	提款相关问题
你们是不是有个啥开户彩金啊赶紧给我加上来 我账号ch9x9x9	体验金咨询
申请注册体验金	体验金咨询
我注册的时间	体验金咨询
你们平台不是注册送彩金的吗	体验金咨询
注册送的彩金可以玩百家乐么	体验金咨询
你好啊，我在我邮箱看到说注册给我免费132彩金是么	体验金咨询
收到邮件说特邀送132？	体验金咨询
我怎么领取注册彩金	体验金咨询
我为什么收不到验证码	体验金咨询
我都按照要求领取下载注册彩金为什么领去不了	体验金咨询
申请注册彩金	体验金咨询
银行卡绑定好了，要申请体验金	体验金咨询
我的邮箱通知我注册送彩金，我第一次注册申请的时候说信息从重不能申请，我第一次注册怎么能从重，就是骗子在别往我邮箱发了昂	体验金咨询
申请注册彩金	体验金咨询
不是新会员送彩金吗	体验金咨询
为什么注册了领不了app.彩金	体验金咨询
注册送彩金能投注体育足球吗？	体验金咨询
体验金可以投注足球吗？	体验金咨询
注册体验金相关咨询	体验金咨询
体验金为什么领取不了	体验金咨询
收到短信说凭短信领取58元	体验金咨询
怎么领不了体验金	体验金咨询
注册重复	体验金咨询
体验金不到账	体验金咨询
先领取132体验金【建议手机流量住冊】	体验金咨询
接到邮箱132体验金怎么回事	体验金咨询
怎么领取开户彩金	体验金咨询
注册怎么不送彩金	体验金咨询
注册送彩金	体验金咨询
邮箱特邀，注册送88	体验金咨询
申请注册彩金	体验金咨询
我收到邮件注册送88	体验金咨询
申请注册彩金	体验金咨询
你好申请彩金123元	体验金咨询
你好，我怎么注册不送下载金吖	体验金咨询
我怎么收不到验证码	体验金咨询
你好 收到邮件说送彩金	体验金咨询
收到邮箱开户88彩金真的吗？	体验金咨询
注册送彩金吗？	体验金咨询
注册送彩金？	体验金咨询
首注册有彩金送吗	体验金咨询
短信提示、注册送128	体验金咨询
注册送多少钱	体验金咨询
怎么密码找回	忘记密码
怎么那个老虎机一直说我密码错误	忘记密码
密码忘了	忘记密码
银行密码忘记了？	忘记密码
忘记帐号和密码了	忘记密码
忘记登录密码	忘记密码
我没有收到密码	忘记密码
我密码忘记了	忘记密码
提示【维护中】	系统维护状况说明
维护吗	系统维护状况说明
邮箱怎么填	修改账号资料
你好，想修改绑定的手机号，注册时用的手机号停用了，	修改账号资料
我的生日日期输入错误	修改账号资料
我的生日日期输入错误	修改账号资料
我注册输入错误了	修改账号资料
个人账户出生日期设置错误可以改吗?	修改账号资料
帮我修改生日日期	修改账号资料
请问我之前的手机丢失了！我可以修改电话号码吗	修改账号资料
我姓名打错了	修改账号资料
我手机没再用了	修改账号资料
名字打错了	修改账号资料
手机没有在用了	修改账号资料
修改帐号资料	修改账号资料
修改帐号资料	修改账号资料
我要修改电话号码怎么	修改账号资料
修改电话	修改账号资料
修改资讯	修改账号资料
我的手机或邮箱没在使用了	修改账号资料
我的生日日期输入错误	修改账号资料
把我那电话号码改一下	修改账号资料
我刚刚注册的号码，电话填错误了怎么办	修改账号资料
手机号输错了	修改账号资料
我注册手机号码换了。帮我改一下	修改账号资料
游戏进不去啊	游戏进不去
pt为什么近不去	游戏进不去
PT进不去？	游戏进不去
EA进不去	游戏进不去
在吗我玩游戏突然掉线了，等我在登陆的时候冻结了	游戏进不去
游戏进不去游戏进不去	游戏进不去
mg游戏进不去	游戏进不去
我帐号总出现您在我们的casinomobile客户端里有未完成的游戏。您现在就可以继续玩，请尽快登录到casinomobile客户端来完成游戏。这个是什么意思。、	游戏进不去
怎么进不去游戏	游戏进不去
还是连接不上游戏	游戏进不去
dt为什么打不开	游戏进不去
不能玩BBIN吗、	游戏进不去
MG游戏怎么进不去了？	游戏进不去
PT前面加什么字母	游戏咨询
pt手机客户端账号怎么填写啊	游戏咨询
我游戏赔付不对	游戏咨询
为什么游戏不出分	游戏咨询
游戏为什么不出分	游戏咨询
游戏为什么不出分	游戏咨询
今天哪个游戏放水	游戏咨询
paopao游戏?	游戏咨询
总是不出分，天天输个十万八万的	游戏咨询
我的赔付怎么不对	游戏咨询
游戏记录	游戏咨询
怎么没有彩票玩	游戏咨询
请问pt手机客户端账号前需要添加什么吗？	游戏咨询
我要查询游戏记录	游戏咨询
游戏记录	游戏咨询
游戏记录	游戏咨询
老虎机怎么玩	游戏咨询
操你妈操你妈操你妈那ｂ游戏我操你妈操你妈操你妈操死你了	游戏咨询
大片ｂ操尼玛尼玛的游戏超人	游戏咨询
PT游戏返水记录没显示	游戏咨询
请问一下，我账上的26元可以玩什么游戏	游戏咨询
pt前加什么	游戏咨询
PT客户端前缀是什么	游戏咨询
三倍猴子在哪个平台？	游戏咨询
有没有三倍猴子	游戏咨询
PT客户端登录前缀加什么字母？	游戏咨询
登录PT客服端账号前面加什么？	游戏咨询
哪个游戏出分	游戏咨询
请问一下，我账上的26元可以玩什么游戏	游戏咨询
操你妈操你妈操你妈那ｂ游戏我操你妈操你妈操你妈操死你了	游戏咨询
大片ｂ操尼玛尼玛的游戏超人	游戏咨询
三倍猴子在哪个平台？	游戏咨询
有没有三倍猴子	游戏咨询
pt客户端前缀加什么	游戏咨询
pt出分游戏	游戏咨询
PT客户端前面加啥	游戏咨询
pt的app登入加什么字母	游戏咨询
我忘记账号了	账号解锁、忘记账号
我的账号忘了	账号解锁、忘记账号
忘记账号了	账号解锁、忘记账号
我忘记了游戏账号	账号解锁、忘记账号
我帐号忘了	账号解锁、忘记账号
网账号忘了	账号解锁、忘记账号
忘记账号密码了	账号解锁、忘记账号
忘记用户名了	账号解锁、忘记账号
我账号密码都忘了怎么找回	账号解锁、忘记账号
我的账号是bbm123456但是我忘记了登入的邮箱	账号解锁、忘记账号
重新帐号	账号解锁、忘记账号
账号被锁	账号解锁、忘记账号
账号被锁	账号解锁、忘记账号
帐号被锁	账号解锁、忘记账号
帐号被锁	账号解锁、忘记账号
账号锁上了	账号解锁、忘记账号
我忘记账号了	账号解锁、忘记账号
帐号锁了	账号解锁、忘记账号
账号忘了	账号解锁、忘记账号
你好，忘记账号，你能帮忙查一下吗	账号解锁、忘记账号
账号忘了	账号解锁、忘记账号
账号被禁用	账号解锁、忘记账号
麻烦你帮我查一下账号	账号解锁、忘记账号
w我的游戏账户被冻结了	账号解锁、忘记账号
老虎机账户里的钱能玩什么游戏	转账咨询
为什么钱转换不了呢	转账咨询
老虎机钱包什么意思啊	转账咨询
怎么转入	转账咨询
怎么钱转换不了呢	转账咨询
我想把钱转到 真人娱乐BBIN厅 怎么转	转账咨询
怎么，我想把钱转到真人娱乐转不了呢	转账咨询
一样转不了	转账咨询
户内转帐	转账咨询
游戏账户间不可对转	转账咨询
游戏账户间不可对转	转账咨询
户内转账	转账咨询
我不能户内转账，转不了	转账咨询
钱在bbln怎么转不出来？	转账咨询
为什么我转账到pt游戏里面然后打开游戏里面却没有钱了	转账咨询
有钱就是不能户内转账	转账咨询
我早sw转账到哪？	转账咨询
最近有什么活动最近有什么活动	咨询当下相关活动
最新活动	咨询当下相关活动
会员日活动是什么？	咨询当下相关活动
申请会员日彩金	咨询当下相关活动
那个存款送彩金是什么意思	咨询当下相关活动
我想知道现在有什么活动	咨询当下相关活动
最新活动	咨询当下相关活动
领取扫微信送8元那个彩金	咨询当下相关活动
最新活动啥的	咨询当下相关活动
每日存款彩金	咨询当下相关活动
最近有什么可以领彩金的活动	咨询当下相关活动
今天有什麽活动	咨询当下相关活动
可以详细说明活动内容吗	咨询当下相关活动
签到怎么玩	咨询当下相关活动
我今天可以签到吗	咨询当下相关活动
优惠申请	咨询当下相关活动
还有别的蕾蕾吗	咨询当下相关活动
我怎么没办法领签到彩金	咨询当下相关活动
申请充值彩金	咨询当下相关活动
签到余额怎么用	咨询当下相关活动
亲申请千百倍奖金	咨询当下相关活动
最近有什么活动	咨询当下相关活动
钱到彩金可以进行游戏吗？	咨询当下相关活动
签到彩金可以进行游戏投注吗	咨询当下相关活动
申请百家乐连赢彩金	咨询当下相关活动
申请百家乐连赢彩金	咨询当下相关活动
申请存款彩金	咨询当下相关活动
申请充值彩金	咨询当下相关活动
申请存就送优惠	咨询当下相关活动
存30送21有什么游戏限制	咨询当下相关活动
申请存款彩金	咨询当下相关活动
存款领彩金	咨询当下相关活动
申请那个存款送红包	咨询当下相关活动
西天取金	咨询当下相关活动
申请西天取金	咨询当下相关活动
申请存款就送钱那个活动	咨询当下相关活动
存30到账28.9那我怎么参加活动	咨询当下相关活动
我现在优惠活动参加不了	咨询当下相关活动
存30送21有什么游戏限制	咨询当下相关活动
论坛优惠	咨询当下相关活动
你好下载就送彩金吗，	咨询当下相关活动
送彩金有什么要求吗	咨询当下相关活动
签到余额怎么转出	咨询当下相关活动
优惠问题	咨询当下相关活动
申请存款彩金	咨询当下相关活动
收到短信说凭短信领取58彩金？	咨询当下相关活动
存50送58	咨询当下相关活动
存款优惠	咨询当下相关活动
我想问下。签到的红包可以干什么	咨询当下相关活动
申请领取荷花	咨询当下相关活动
申请千百呗奖励	咨询当下相关活动
申请会员周年日彩金	咨询当下相关活动
存就送	咨询当下相关活动
申请存款彩金	咨询当下相关活动
存款彩金	咨询当下相关活动
申请存款彩金	咨询当下相关活动
存款彩金	咨询当下相关活动
存款彩金	咨询当下相关活动
申请存款彩金	咨询当下相关活动
签到余额怎么转出	咨询当下相关活动
历史存款累积满5000（包含5k)以上用户存200送18元存1000送88元5倍老虎机任意平台未达要求且新注册用户存100送8元存1000送38元5倍老虎机任意平台	咨询当下相关活动
存款送彩金活动	咨询当下相关活动
申请存款彩金	咨询当下相关活动
我可以参加什么优惠活动	咨询当下相关活动
我可以申请什么优惠活动	咨询当下相关活动
每天支付宝转账到200是不是可以领是那么优惠呀	咨询当下相关活动
存30送21有什么游戏限制	咨询当下相关活动
这个签到彩金怎么使用啊	咨询当下相关活动
我存款31怎么没有分呀	咨询当下相关活动
请问申请了自助存送优惠，SLOT存100送五十！只能投那些游戏？	咨询当下相关活动
申请彩金	咨询当下相关活动
我今天pt没有申请存30送21.怎么我没法申请呀	咨询当下相关活动
怎么系统提示超过最大使用次数呀	咨询当下相关活动
我只是申请了老虎机钱包优惠。存30送21	咨询当下相关活动
存款红包t	咨询当下相关活动
申请个存款红包	咨询当下相关活动
会员周年日	咨询当下相关活动
申请下存200送18彩金	咨询当下相关活动
申请存款红包	咨询当下相关活动
不是说送彩金的么?	咨询当下相关活动
今天存款红包申请	咨询当下相关活动
存款够两百申请红包	咨询当下相关活动
领取存款红包	咨询当下相关活动
存30送21需要多少流水	咨询当下相关活动
久安使用后，咋领奖金	咨询当下相关活动
申请充值就送	咨询当下相关活动
每天58元反赠是什么意思	咨询当下相关活动
反水	返水咨询
百家乐几点反水	返水咨询
我问下每天的游戏没有反水的吗？	返水咨询
怎么反水	返水咨询
你好ag反水怎么还不到？	返水咨询
反水不对	返水咨询
怎么看注册时间？	官网及账号问题
我怎么不能注册帐号	官网及账号问题
我什么时候注册的	官网及账号问题
我注册是几号	官网及账号问题
我几号注册的	官网及账号问题
帮我查下注册日	官网及账号问题
我的注册日期多少	官网及账号问题
查查我的注册时间	官网及账号问题
您好 请问您那边需要广告宣传么	官网及账号问题
请问您需要推广	官网及账号问题
我是代理，麻烦吧代理专员的QQ微信发我一下	官网及账号问题
你好！代理在哪里登录	官网及账号问题
你好，我是网络推广的，现在世界杯了，我们凤凰网体育频道流量很高，方便给一下你们相关负责人的联系方式吗？	官网及账号问题
微信客服消息都不回我	官网及账号问题
你们网站注册怎么老是提示密码不正确	官网及账号问题
您好~请问贵司需要网赚引流精准渠道推广的业务吗？	官网及账号问题
麻烦你告我一下QQ客服的QQ号	官网及账号问题
请问我注册的代理通过了吗	官网及账号问题
我的微信客服微信是多少	官网及账号问题
请问贵公司有入款通道需求吗 网关快捷 扫码H5	官网及账号问题
你们客服qq是不是54682155474	官网及账号问题
你们客服打电话给我说让我加她qq，给我送彩金，结果加了没反应	官网及账号问题
你们qq专员都没反应的	官网及账号问题
我的接到电话你们客服说给彩金	官网及账号问题
我是你们特邀会员	官网及账号问题
你们客服qq是不是3467889842	官网及账号问题
找不到专属客服的的添加方式	官网及账号问题
怎么我的代理密码错误的	官网及账号问题
世界杯来了，贵公司需要推广宣传吗？	官网及账号问题
这个是你微信客服发给我的怎么我用不起他说被人领取了	官网及账号问题
你们负责官网推广的负责人联系方式能给一个吗？我想跟你们官网合作	官网及账号问题
可以看一下我这个账号注册多久了吗?	官网及账号问题
账号注册时间	官网及账号问题
申请存款彩金	官网及账号问题
领取存款彩金	官网及账号问题
我怎么不能注册帐号。	官网及账号问题
QQ客服没在可以申请存200送两百吗？	官网及账号问题
你们客服说的我存多少送多少，我没得到，他说他给我申请红包红包没得到，发信息回都不回了什么意思	官网及账号问题
查一下我什么时候注册的	官网及账号问题
我账号的注册时间	官网及账号问题
查一下账号的注册时间	官网及账号问题
我可以在哪里看到账号啥时注册的	官网及账号问题
怎么推荐好友	好友推荐
我邀请一个人能给我什么好处	好友推荐
pt手机手机客服端怎样下载的	好友推荐
收到短信说我有2个红包	红包咨询
特邀彩金是什么	红包咨询
申请转运红包	红包咨询
怎么领取邮箱特邀	红包咨询
你好帮我申请上一个的转运红包	红包咨询
我申请那转运红包什么时候给我	红包咨询
转运红包申请一天了	红包咨询
给个红包	红包咨询
红包	红包咨询
我的转运红包为什么还没到	红包咨询
申请个红包	红包咨询
麻烦看我看下我昨天申请的转运红包可以了嘛	红包咨询
抢你麻痹红包，说的好听可以抢红包，草，抢三个还没有3块钱。还不能转账。你们的游戏是专门坑钱的么？	红包咨询
申请转运红包	红包咨询
我要红包	红包咨询
信息里发的红包优惠券用不了	红包咨询
为什么每月免费红包没有开启啊	红包咨询
邮箱特邀132	红包咨询
收到短信说我有2个红包	红包咨询
救援金几点发	救援金咨询
什么时候发救援金	救援金咨询
救援金派发了吗	救援金咨询
今天的救援金怎么还不派发，都输没了	救援金咨询
我昨天的救援金怎么还没显示	救援金咨询
救援金什么时候发	救援金咨询
为什么我没有救援金	救援金咨询
我的救援金怎么没发放？	救援金咨询
救援金是什么时候补发	救援金咨询
我为什么领不到救援金？	救援金咨询
你好，请问我怎么从来没有救援金	救援金咨询
帮我绑定银行卡	密保银行卡解绑
银行卡忘记用哪一张了	密保银行卡解绑
银行卡可以换吗?我刚刚绑错了	密保银行卡解绑
为什么我的银行卡绑不了	密保银行卡解绑
解绑卡	密保银行卡解绑
你好，怎么取消之前绑定的银行卡	密保银行卡解绑
我的工商卡已经没有用了 要重新绑定 怎么绑定不了	密保银行卡解绑
我要解绑银行卡	密保银行卡解绑
我要解绑银行卡	密保银行卡解绑
我要解绑密保	密保银行卡解绑
解绑银行卡	密保银行卡解绑
密保	密保银行卡解绑
为什么我首存没送呢？	首存咨询
你好，帮我查一下我的号有没有首存	首存咨询
存送优惠，有什么游戏限制吗	首存咨询
账号是否可以参加首存优惠呢	首存咨询
请问转账那个需要流水我还差么	刷新流水
帮我刷新pt流水	刷新流水
帮我更新下流水	刷新流水
流水限制卡了？给刷新下！	刷新流水
我从注册到现在打多少流水了	刷新流水
把握刷新pt流水	刷新流水
我这个月的流水有20万了吧	刷新流水
帮我查下我今天所有平台的流水	刷新流水
我要户内转账，麻烦您帮我刷一下流水，谢谢！	刷新流水
老虎机送35%的优惠，需要多少流水才能转账？	刷新流水
要户内转帐，帮忙刷新下流水	刷新流水
为什么说我没有投注	刷新流水
我pt流水到了怎么转不了账啊	刷新流水
要户内转帐，帮忙刷新下流水	刷新流水
帮我看看我有多少流水	刷新流水
我这个月的流水有20万了吧，怎么还没刷新阿	刷新流水
帮我看下我今天的流水有多少	刷新流水
转账怎么还流水限制	刷新流水
你好，请帮我更新一下流水	刷新流水
农业银行怎么提不了款？	提款相关问题
我提款怎么还没到	提款相关问题
我提款怎么还没到账	提款相关问题
你好我的提款密码忘记了	提款相关问题
你们提款怎么这么慢	提款相关问题
请问我提的款怎么还不到账呢？	提款相关问题
我提现怎么到不了帐	提款相关问题
提款要多久	提款相关问题
我提款20分钟了怎么还在审核的？	提款相关问题
出款没有到	提款相关问题
我的提款怎么取消了	提款相关问题
秒付提款未通过审核是什么意思啊？	提款相关问题
怎么提款提不了	提款相关问题
怎么提钱喔	提款相关问题
请问一下我刚才有笔提款怎么一直不到账？？？	提款相关问题
你好我提款怎么提不到呢	提款相关问题
咋提款都没到帐	提款相关问题
提款咋没到账	提款相关问题
提款咋没到账	提款相关问题
提款咋还没到账	提款相关问题
提款	提款相关问题
提款呢	提款相关问题
我的提款还没到阿	提款相关问题
怎么不能提现吗	提款相关问题
把我提款取消是么意思捏	提款相关问题
什么情况啊？提款了二十多分钟都没审核	提款相关问题
查询下提款怎么还没到	提款相关问题
你好，我昨天的一笔提款，今天还是在审核状态	提款相关问题
我提款都审核了，怎么又取消了	提款相关问题
我的提款怎么又没有成功？	提款相关问题
为什么不让我提现啊	提款相关问题
我出款怎么半天没到账	提款相关问题
提款很久很久未到账	提款相关问题
提款申请半小时了	提款相关问题
提现还没有到	提款相关问题
一般提款什么时候能到	提款相关问题
您好我的提现为什么还没到	提款相关问题
我取款密码忘了	提款相关问题
农业银行怎么提不了款？	提款相关问题
怎怎么提款	提款相关问题
我想提款	提款相关问题
怎么提款呀	提款相关问题
我提款怎么还没到	提款相关问题
怎么没有送注册彩金	体验金咨询
怎么申请注册礼金	体验金咨询
注册怎么没有送	体验金咨询
你帮我看一下注册信息重复领不了彩金	体验金咨询
我才注册的账号，怎么不可以申请注册彩金	体验金咨询
不是注册就送彩金吗	体验金咨询
我的已经注册好了！但是手机收不到验证码！领不到彩金怎么办	体验金咨询
注册领取88彩金	体验金咨询
是不是注册就送8-88？	体验金咨询
注册有彩金送么	体验金咨询
怎么自取不了注册彩金！	体验金咨询
申请自助体验金	体验金咨询
注册有优惠吗	体验金咨询
注册新号送体验金吗？	体验金咨询
为什么我刚注册没有彩金？	体验金咨询
请问新注册的有木有免费彩金发啊	体验金咨询
请问你们公司注册就送88彩金吗？	体验金咨询
申请注册体验金	体验金咨询
特邀注册送72	体验金咨询
你好，我收到你们公司发的邮件，说注册就送彩金 是真的吗	体验金咨询
收到你们的短信说注册送69	体验金咨询
请问为啥不能申请APP下载彩金？说啥资料重复？我是第一次在你们网站注册	体验金咨询
下载app的体验金怎么没有收到呢	体验金咨询
说我重复注册是怎么回事	体验金咨询
现在还有注册送彩金活动吗	体验金咨询
开户体验金怎么申请	体验金咨询
注册送88怎么送的	体验金咨询
收到你们公司的vip特邀邮件来注册，说注册下载app送彩金，可是我这注册了为什么无法申请呢	体验金咨询
你好  注册送彩金是吗	体验金咨询
我申请体验金，刚好手机停机了，怎么办？收不了验证码	体验金咨询
我怎么收不到手机验证码的？语音也不行	体验金咨询
我都弄好了也没看见体验金啊	体验金咨询
体验金	体验金咨询
申请注册礼金	体验金咨询
不是说下载app送体验金么	体验金咨询
申请注册体验金	体验金咨询
app体验金只能玩老虎机?	体验金咨询
现在还有注册送彩金活动吗	体验金咨询
重复注册什么意思	体验金咨询
你好注册送88吗	体验金咨询
怎么申请注册礼金	体验金咨询
我怎么不能注册帐号	体验金咨询
新注册帐号zz187166申请注册彩金	体验金咨询
怎么没有送注册彩金	体验金咨询
申请活跃彩金	体验金咨询
我登录密码忘了	忘记密码
密码忘记了	忘记密码
你们能不能帮我找回密码	忘记密码
登录密码忘了怎么修改？	忘记密码
我是新注册客户把登录密码忘了	忘记密码
我忘记密码，主要是俩三年没玩了	忘记密码
找回密码	忘记密码
不好意思，登陆密码忘了	忘记密码
我不记得登录密码了	忘记密码
密码找回	忘记密码
你好，我忘记密码了	忘记密码
我要修改密码	忘记密码
密码忘记了	忘记密码
我登录密码忘了	忘记密码
找回密码怎么弄	忘记密码
现在是整个服务器都在维护吗？	系统维护状况说明
妈了个逼还得维护多长时间	系统维护状况说明
DT还的维护多长时间	系统维护状况说明
现在游戏在维护吗	系统维护状况说明
游戏在维护吗	系统维护状况说明
怎么还维护呢	系统维护状况说明
bbin还要维护多久	系统维护状况说明
DT游戏还在维护吗	系统维护状况说明
维护到什么时候	系统维护状况说明
请问怎么修改手机号码？	修改账号资料
能改手机号吗	修改账号资料
我的电话号码没有用了，怎么可以修改手机号码	修改账号资料
我电话号码输错了	修改账号资料
我原来的手机号没用了，怎么改过来	修改账号资料
修改电话	修改账号资料
我的手机号后面输错了一位数	修改账号资料
我想修改手机号怎么改	修改账号资料
你好，我绑定的手机号码不用了，换一个号码绑定上可以吗	修改账号资料
为什么我点击下载app积金输不了名字	修改账号资料
你好更改电话号码	修改账号资料
手机号码更换	修改账号资料
可以更改电话吗	修改账号资料
电话号码换不了吧？	修改账号资料
个人账户出生日期设置错误可以改吗?	修改账号资料
帮我修改生日日期	修改账号资料
手机号可不可以改	修改账号资料
你好！我想更换电话号码在哪更换	修改账号资料
原来的电话号码不用了可以换吗？	修改账号资料
帮我吧注册的电话换下	修改账号资料
我电话号码绑定错误了	修改账号资料
怎么修改电话号码	修改账号资料
我还电话号码，怎么改呢	修改账号资料
请帮我俢改手机号	修改账号资料
我想更换电话号码在哪更换	修改账号资料
可不可以更改电话号码	修改账号资料
能改手机号吗	修改账号资料
请问怎么修改手机号码？	修改账号资料
我想要绑定姓名	修改账号资料
问什么DT游戏玩不了	游戏进不去
DT游戏怎么进不去啊进去就弹出来进去就弹出来	游戏进不去
我下载的DT游戏咋登录不了	游戏进不去
你们的DT老虎机不能玩？	游戏进不去
pT能进去。DT他妈的进不去	游戏进不去
为卅我进dt怎么都进不去	游戏进不去
游戏怎么玩不了	游戏进不去
游戏怎么打不开	游戏进不去
为什么老虎机机MG游戏玩不了啊，点进去显示无法加载游戏	游戏进不去
我在打糖果派对，突然就卡起了。我退出来重新进里面就没有钱了	游戏进不去
沙巴体育怎么进不去	游戏进不去
DT游戏还在维护吗	游戏进不去
我打不开游戏，刚才客服教我卸载后重新下载，还是打不开	游戏进不去
我的游戏卡了你能处理吗	游戏进不去
pt怎么玩不了	游戏进不去
刚刚中张飞头奖怎么给我卡住，断线了	游戏进不去
TPSW游戏（五虎将）免费旋转中得头奖，给我卡住了，掉线了	游戏进不去
你好，请帮我碎裂游戏	游戏进不去
问什么DT游戏玩不了	游戏进不去
DT游戏怎么进不去啊进去就弹出来进去就弹出来	游戏进不去
怎么游戏近不去啊	游戏进不去
pt怎么近不去	游戏进不去
我要玩mg为什么近不去	游戏进不去
PT今天什么游戏出分	游戏咨询
怎么登陆pt客服端	游戏咨询
pt游戏局号怎么查询	游戏咨询
今日有出分爆料吗	游戏咨询
没有彩票的吗	游戏咨询
qpp登陆加不加什么	游戏咨询
今天QT和PNG平台那些游戏出分高	游戏咨询
sw出分高点的游戏	游戏咨询
手机客服端pt前面加什么	游戏咨询
请问pt手机客户端账号前需要添加什么吗？	游戏咨询
帮我查中午的游戏记录，sw平台的	游戏咨询
体育世界杯投注亏损今天不算吗	游戏咨询
小宝，今天哪个游戏好玩	游戏咨询
请问登录前面应该加什么符号	游戏咨询
今天的pt游戏推荐是什么	游戏咨询
现在什么游戏比较出分	游戏咨询
给我看看pt和sw出分游戏	游戏咨询
我想问一下赔付率会不会出错？	游戏咨询
可以查询游戏记录吗?	游戏咨询
Pt DT ttg目前哪款游戏爆分	游戏咨询
SW DT现在出分的游戏	游戏咨询
你们的游戏 吃钱吃得太厉害了	游戏咨询
账号被禁用？	账号解锁、忘记账号
我忘记了会员帐号	账号解锁、忘记账号
给我吧账号解锁下	账号解锁、忘记账号
我的账号忘了	账号解锁、忘记账号
我忘记账号了	账号解锁、忘记账号
我帐号密码忘记了被冻结了	账号解锁、忘记账号
忘记会员账号密码	账号解锁、忘记账号
我账号没记住给忘了，能帮忙给查一下吗	账号解锁、忘记账号
账号锁了！登录密码忘了	账号解锁、忘记账号
我的账号和密码忘记了	账号解锁、忘记账号
我忘记账号了	账号解锁、忘记账号
我帐号忘了	账号解锁、忘记账号
解锁账号	账号解锁、忘记账号
忘记账号了怎么办	账号解锁、忘记账号
我的手机号被注册过了，能帮我查下账号吗	账号解锁、忘记账号
客服，请帮助登录帐号解锁一下。帐号  sss369	账号解锁、忘记账号
账号冻结	账号解锁、忘记账号
账号被冻结	账号解锁、忘记账号
帐号解锁	账号解锁、忘记账号
账号被禁用？	账号解锁、忘记账号
账号冻结了	账号解锁、忘记账号
slot是什么意思	转账咨询
我一键回归额度怎么钱转不见了？	转账咨询
老虎机钱包可以玩哪些老虎机	转账咨询
bbin账户的钱突然不见了	转账咨询
我想玩MG游戏，可是不知道户内转账转到哪里	转账咨询
我的钱在老虎机帐户里	转账咨询
申请充值就送钱	咨询当下相关活动
存款就送钱那个彩金怎么就不给我呢	咨询当下相关活动
申请存200送18元	咨询当下相关活动
申请取金路上彩金	咨询当下相关活动
申请存款彩金	咨询当下相关活动
申请支付宝存款奖金	咨询当下相关活动
申请1000送88	咨询当下相关活动
申请存钱奖励	咨询当下相关活动
今天有没有充值就送钱的活动	咨询当下相关活动
申请存款红包	咨询当下相关活动
存款领彩金	咨询当下相关活动
申请2018尽享收益、充值就送钱	咨询当下相关活动
参加西方取经活动	咨询当下相关活动
申请存100送8	咨询当下相关活动
会员日活动是什么？	咨询当下相关活动
申请会员日彩金	咨询当下相关活动
请问我的会员日是哪个月	咨询当下相关活动
会员日彩金需要打几倍流水	咨询当下相关活动
领取会员周年日活动	咨询当下相关活动
是不是可以申请会员周年日	咨询当下相关活动
帮我查一下我的会员日好吗	咨询当下相关活动
申请个会员日彩金名额满了？	咨询当下相关活动
周年日彩金可以领吗	咨询当下相关活动
会员日彩金要怎么申请？	咨询当下相关活动
申请会员一周年奖金	咨询当下相关活动
会员周年日彩金我能领取吗	咨询当下相关活动
你好美女！能申请会员周年日优惠吗？	咨询当下相关活动
会员日彩金还有名额吗？	咨询当下相关活动
我的会员日是哪天	咨询当下相关活动
可以领周年礼金不	咨询当下相关活动
能不能查查我什么时候注册的	咨询当下相关活动
那个存款送彩金是什么意思	咨询当下相关活动
申请存款红包	咨询当下相关活动
申请周年日彩金	咨询当下相关活动
上月签到彩金怎么没有呢	咨询当下相关活动
现在是不是有存送	咨询当下相关活动
申请存款彩金	咨询当下相关活动
是不是有存送	咨询当下相关活动
再帮忙看看我有啥免费彩金可以领取的？	咨询当下相关活动
申请会员周年彩金	咨询当下相关活动
申请支付宝存款奖金	咨询当下相关活动
充值就送这么领	咨询当下相关活动
我申请存款送红包	咨询当下相关活动
申请充值彩金	咨询当下相关活动
申请存款送现金	咨询当下相关活动
申请存款送彩金	咨询当下相关活动
我的APP朋友圈打卡10天彩金为什么还不派发给我	咨询当下相关活动
千倍百倍什么时候发	咨询当下相关活动
麻烦你帮查询下我的账号参加老虎机充30送21的优惠活动是否可还可以参加。是否超过最大使用次数。	咨询当下相关活动
我能领取什么奖金吗	咨询当下相关活动
签到金有什么用？	咨询当下相关活动
我要申请充值送彩金	咨询当下相关活动
申请充值200送18红包	咨询当下相关活动
签到领的余额不能玩游戏嘛	咨询当下相关活动
领取存款红包	咨询当下相关活动
会员周年日彩金我能领取吗	咨询当下相关活动
我可以领取什么奖金？	咨询当下相关活动
申请存钱红包	咨询当下相关活动
申请存款彩金	咨询当下相关活动
申请存钱送红包	咨询当下相关活动
签到签到余额怎么用	咨询当下相关活动
客服给我打电话说送彩金	咨询当下相关活动
签到余额不能户内转账吗	咨询当下相关活动
申请百家乐连赢彩金	咨询当下相关活动
下载久安钱包没彩金	咨询当下相关活动
你好怎么领取签到的钱	咨询当下相关活动
你好我问一下，就是那个年货优惠我忘喽生情，我现在可以生情吗	咨询当下相关活动
今天输了很多有什么彩金可申请?	咨询当下相关活动
我的充值积分怎么没变化	咨询当下相关活动
亲，今日存款10块送20吗	咨询当下相关活动
你好，请问31号存10元可申请什么优惠？	咨询当下相关活动
最近活动	咨询当下相关活动
最近活动有什么	咨询当下相关活动
有什么活动	咨询当下相关活动
现在是不是有存送	咨询当下相关活动
最近有什么活动	咨询当下相关活动
申请充值200送18	咨询当下相关活动
现在有什么活动	咨询当下相关活动
申请存款红包	咨询当下相关活动
上月签到彩金怎么没有呢	咨询当下相关活动
最近活动	咨询当下相关活动
char3ing申请周年日彩金	咨询当下相关活动
最近活动	咨询当下相关活动
现在有什么活动	咨询当下相关活动
最近有什么活动最近有什么活动	咨询当下相关活动
最强存送怎么申请	咨询当下相关活动
最近活动	咨询当下相关活动
今天还有充值200送18？	咨询当下相关活动
最近活动最近活动	咨询当下相关活动
最近有什么活动	咨询当下相关活动
现在有什么活动	咨询当下相关活动
你们打电话我说放款加你们微信冲钱送多少	咨询当下相关活动
西天取金是什么	咨询当下相关活动
七夕那个活动	咨询当下相关活动
周年彩金怎么领取	咨询当下相关活动
