我账户的钱转不见了	转账咨询
我的存款不知道转入什么游戏平台了	转账咨询
我没办法转账	转账咨询
想玩MG，转账到哪个钱包呢	转账咨询
怎么户内转帐	转账咨询
怎么不能转账了	转账咨询
沙巴体育怎么转帐	转账咨询
我户内转账的钱不见了	转账咨询
我户内转账的钱不见了	转账咨询
我的转账转不进去	转账咨询
我户内转账的钱不见了	转账咨询
帮我查一下游戏账号	账号解锁、忘记账号
为什么我的账号被封了	账号解锁、忘记账号
忘记帐号	账号解锁、忘记账号
账号找回	账号解锁、忘记账号
收不到忘记账号的短信	账号解锁、忘记账号
账号被锁定	账号解锁、忘记账号
忘了	账号解锁、忘记账号
我朋友害我账号被禁用了	账号解锁、忘记账号
我账号怪怪的	账号解锁、忘记账号
忘记帐号	账号解锁、忘记账号
忘记账号	账号解锁、忘记账号
我账号忘记了	账号解锁、忘记账号
帮我解冻	账号解锁、忘记账号
账号被锁定	账号解锁、忘记账号
我的账号为什么被冻结了	账号解锁、忘记账号
账号被锁定	账号解锁、忘记账号
申请存款红包	红包咨询
申请转运红包	红包咨询
特邀红包	红包咨询
存送优惠券怎么申请	红包咨询
红包	红包咨询
给我红包	红包咨询
给红包吗？	红包咨询
特邀	红包咨询
申请活跃红包	红包咨询
如何使用存送优惠券	红包咨询
申请转运金	红包咨询
领取充值红包	红包咨询
特邀彩金	红包咨询
邮件的特邀彩金	红包咨询
给我来个红包	红包咨询
申请转运红包	红包咨询
送我个红包	红包咨询
我忘记邮箱手机不用了可以找回密码吗	忘记密码
密码怎么改	忘记密码
密码给忘了	忘记密码
改不了密码	忘记密码
我收不到密码、帐号的短信或邮箱	忘记密码
密码怎么改	忘记密码
密码给忘了	忘记密码
密码给忘了	忘记密码
密码忘了	忘记密码
密码忘了	忘记密码
密码忘了	忘记密码
我收不到忘记密码的短信或邮件	忘记密码
密码忘了	忘记密码
密码怎么改	忘记密码
忘记密码了	忘记密码
密码忘了	忘记密码
密码忘了	忘记密码
忘记密码收不到新密码	忘记密码
收不到忘记密码的短信	忘记密码
没收到新密码	忘记密码
密码忘了	忘记密码
密码忘了	忘记密码
密码忘记了	忘记密码
我收不到忘记密码的短信或邮件	忘记密码
收不到新密码	忘记密码
给我换新密码	忘记密码
密码忘记了	忘记密码
收不到密码	忘记密码
游戏一直断	游戏进不去
PT怎么一直断啊	游戏进不去
MG一直断线	游戏进不去
错误编码	游戏进不去
错误编码2	游戏进不去
PT错误	游戏进不去
错误编码22、23、28	游戏进不去
怎么一直断	游戏进不去
游戏一直断	游戏进不去
游戏一直断	游戏进不去
游戏一直不能玩	游戏进不去
游戏一直登不进去	游戏进不去
我在使用pt客户端玩游戏进不去	游戏进不去
我MG不能玩游戏	游戏进不去
怎么一直断啊	游戏进不去
网页打不开或官网进不去	游戏进不去
PT进不去	游戏进不去
MG进不去	游戏进不去
PNG进不去	游戏进不去
PTSKY进不去	游戏进不去
DT不能游戏	游戏进不去
PTSKY不能游戏	游戏进不去
NT不能游戏	游戏进不去
NT进不去	游戏进不去
PT打不开	游戏进不去
PT打不开	游戏进不去
MG打不开	游戏进不去
MG不能游戏	游戏进不去
MG不能游戏	游戏进不去
PNG不能游戏	游戏进不去
NT不能游戏	游戏进不去
DT不能游戏	游戏进不去
PTSKY不能游戏	游戏进不去
不能游戏	游戏进不去
PT进不去	游戏进不去
DT进不去	游戏进不去
哪些游戏好打	游戏进不去
手机打不开游戏	游戏进不去
游戏怎么上不去啊	游戏进不去
游戏不能玩	游戏进不去
我游戏不能玩	游戏进不去
客户端进不去	游戏进不去
免费游戏卡住了	游戏进不去
游戏怎么断线了？	游戏进不去
游戏不能玩	游戏进不去
游戏不能玩	游戏进不去
游戏一直断线	游戏进不去
游戏掉线进不去	游戏进不去
画面很卡，进不去游戏	游戏进不去
我刚刚的球赛注单哪看	游戏咨询
怎么中奖了没给我分	游戏咨询
中奖了给的钱不对	游戏咨询
有什么热门游戏	游戏咨询
你们有bbin的游戏吗	游戏咨询
先试玩在考虑要不要注册	游戏咨询
能试玩一下游戏吗	游戏咨询
账号前面加什么	游戏咨询
用什么前缀	游戏咨询
我想查体育的注单	游戏咨询
用什么前缀	游戏咨询
我问您平台的体育怎么玩	游戏咨询
账号前面加什么	游戏咨询
哪个老虎机好玩	游戏咨询
pt前缀	游戏咨询
百家乐怎么玩	游戏咨询
有什么好玩的游戏	游戏咨询
有推荐的游戏吗	游戏咨询
今天出分	游戏咨询
PT游戏记录	游戏咨询
不会出分的网站	游戏咨询
推荐出分游戏	游戏咨询
有什么好玩点的游戏吗	游戏咨询
我MG不能玩游戏	游戏咨询
我想查询游戏的赔付问题	游戏咨询
PT客户端前缀？	游戏咨询
pt客户端前面加什么	游戏咨询
PT客户端前缀	游戏咨询
pt客户端前面加什么	游戏咨询
出分游戏	游戏咨询
我要去玩游戏了	游戏咨询
游戏不出分	游戏咨询
派彩有问题	游戏咨询
推荐一下出分游戏	游戏咨询
有什么好玩的游戏吗	游戏咨询
PT客户端前面要加啥?	游戏咨询
游戏登入前缀要加什么	游戏咨询
PT前面加什么字母吗	游戏咨询
你们BBIN的游戏有哪些好玩的	游戏咨询
你们能用花呗吗	存款相关问题
有花呗支付吗?	存款相关问题
京东白条可以存吗	存款相关问题
存款没有到账	存款相关问题
存不了款	存款相关问题
有久安钱包吗	存款相关问题
久安存款没到	存款相关问题
银联扫码150没到账	存款相关问题
你们家存款真慢	存款相关问题
有什么存款方式	存款相关问题
怎么不能存款	存款相关问题
我要取消订单	存款相关问题
存款有哪些可以用	存款相关问题
我看不到我存的	存款相关问题
未到账	存款相关问题
我是说点卡充不起	存款相关问题
我的存款都还没到	存款相关问题
秒存秒到帐?	存款相关问题
存款	存款相关问题
怎么存款	存款相关问题
怎么存款	存款相关问题
怎么存款	存款相关问题
怎么存款	存款相关问题
存款	存款相关问题
存款	存款相关问题
存款	存款相关问题
微信存款没有到账	存款相关问题
我存款怎么没看见	存款相关问题
点卡现在还没到	存款相关问题
存款没到	存款相关问题
我在存款时被提示活跃度不足	存款相关问题
怎么存款	存款相关问题
久安支付是什么	存款相关问题
秒存怎么存	存款相关问题
存款	存款相关问题
我支付宝扫码付款上100分没到	存款相关问题
你好微信转账怎么关闭了	存款相关问题
我上了分多久了都没到你帮我看看	存款相关问题
久安钱包冲值不到帐	存款相关问题
存款没有到账	存款相关问题
怎么加微信客服	存款相关问题
怎么又不到账？	存款相关问题
存款没到	存款相关问题
支付宝怎么存款	存款相关问题
微信转账没有到	存款相关问题
签到怎么提款不了	咨询当下相关活动
签到提款	咨询当下相关活动
有什么优惠	咨询当下相关活动
什么优惠	咨询当下相关活动
你帮我看一下我可以申请什么优惠	咨询当下相关活动
你帮我看看我可以参加那些优惠	咨询当下相关活动
帮我看看我有什么优惠可以领	咨询当下相关活动
VIP有什么优惠	咨询当下相关活动
晋级有优惠吗	咨询当下相关活动
VIP有哪些优惠	咨询当下相关活动
要在哪里签到	咨询当下相关活动
要怎么签到	咨询当下相关活动
签到活动要怎么提款出来	咨询当下相关活动
没办法领签到彩金	咨询当下相关活动
有哪些优惠	咨询当下相关活动
签到活动	咨询当下相关活动
优惠	咨询当下相关活动
优惠	咨询当下相关活动
最近啥活动好打	咨询当下相关活动
活动不给力	咨询当下相关活动
本月有什么优惠	咨询当下相关活动
今天有什么好活动	咨询当下相关活动
签到	咨询当下相关活动
你们有什么优惠	咨询当下相关活动
你们官网有啥优惠	咨询当下相关活动
今天有什么优惠	咨询当下相关活动
今天有什么优惠	咨询当下相关活动
存款有优惠吗	咨询当下相关活动
在哪里签到	咨询当下相关活动
查查我可以领什么优惠	咨询当下相关活动
我要申请次存	次存咨询
次存怎么不能申请	次存咨询
次存不能用	次存咨询
次存的红利多少	次存咨询
次存在哪里申请	次存咨询
次存红利	次存咨询
次存不能用	次存咨询
第一次存多少送多少	次存咨询
第一次存多少送多少	次存咨询
我不会申请次存	次存咨询
次存打多少可以提款	次存咨询
帮我刷一下投注额	刷新流水
看一下现在投注多少了	刷新流水
帮我看一下投注到了没	刷新流水
看一下我的投注多少了	刷新流水
帮我看现在投注多少了	刷新流水
帮我刷新一下投注额	刷新流水
帮我刷一下投注	刷新流水
帮我查一下现在投注多少了	刷新流水
帮我查下今天的投注额	刷新流水
帮我查下投注额	刷新流水
查我PT的流水	刷新流水
提款打多少流水	刷新流水
刷一下流水	刷新流水
刷新一下投注	刷新流水
刷新一下投注	刷新流水
查流水	刷新流水
我要查流水	刷新流水
刷一下流水	刷新流水
刷刷流水	刷新流水
刷一下流水	刷新流水
帮我刷流水	刷新流水
帮我刷流水	刷新流水
流水刷新没	刷新流水
流水查询	刷新流水
查询我晋级的流水	刷新流水
请帮我刷新下流水	刷新流水
你可以帮我查流水吗	刷新流水
首存有什么游戏限制	首存咨询
第一笔存款有送吗	首存咨询
首存要多少流水	首存咨询
首存多少流水	首存咨询
怎么没办法首存啊	首存咨询
怎么申请首存	首存咨询
在哪边申请首存	首存咨询
首存流水	首存咨询
首存多少流水	首存咨询
怎么没办法首存啊	首存咨询
首存送多少	首存咨询
首存送多少	首存咨询
哪里申请首存	首存咨询
我不会申请首存	首存咨询
你们首存优惠需要多少流水提款	首存咨询
首存优惠怎么申请的	首存咨询
我要申请首存	首存咨询
我要申请首存	首存咨询
首存也可以玩古怪猴子吗	首存咨询
帮我查下总存款	查询账号状态
我的注册邮箱输入错误	修改账号资料
我注册时姓名写错了	修改账号资料
我想要更改我的手机号码现在不用了	修改账号资料
修改银行卡	修改账号资料
手机号可以换吗	修改账号资料
账号很久没用了，以前手机绑定可以更换吗	修改账号资料
我要修改注册电话	修改账号资料
修改注册电话	修改账号资料
我的手机或邮箱没在使用了	修改账号资料
提示【维护中】	系统维护状况说明
天天维护都不能玩	系统维护状况说明
维护吗？	系统维护状况说明
你们游戏在维护吗	系统维护状况说明
微信转账还没有维护好吗	系统维护状况说明
你好	前置场景
你帮我看看我的救援金可以拿多少	救援金咨询
怎么没有救援金	救援金咨询
救援金要几倍流水	救援金咨询
我为什么没有救援金	救援金咨询
怎么给我的救援金少了	救援金咨询
怎么没有救援金	救援金咨询
救援金不对	救援金咨询
救援金给好少	救援金咨询
救援金给好少，都不够赢	救援金咨询
救援金给好少，都不够赢	救援金咨询
救援金给好少，都不够赢	救援金咨询
我的救援金为什么这么少	救援金咨询
救援金怎么还没到	救援金咨询
救援金我怎麽没有	救援金咨询
我是第一次注册怎么说我注册过	官网及账号问题
论坛怎么进不去	官网及账号问题
我想要再注册一个账号可以吗	官网及账号问题
这账号我不要了，可以再注册一个吗	官网及账号问题
重新注册吗	官网及账号问题
注册不了	官网及账号问题
可以重新注册吗	官网及账号问题
帮忙注册账号吗	官网及账号问题
我要怎么注册	官网及账号问题
我是代理	官网及账号问题
我要咨询代理拥金	官网及账号问题
代理几点上班？	官网及账号问题
我要重新注册可以吗	官网及账号问题
您好！请问贵公司需要做广告推广吗？	官网及账号问题
为什么总是注册不成功	官网及账号问题
代理佣金提现一般多久到账	官网及账号问题
体验金提款要多少流水	体验金咨询
体验金能玩什么游戏	体验金咨询
体验金可以玩什么游戏	体验金咨询
体验金不能玩什么游戏	体验金咨询
体验金能玩什么游戏	体验金咨询
体验金	体验金咨询
体验金	体验金咨询
收不到验证码	体验金咨询
系统提示信息重复&银行卡重复	体验金咨询
为什么收不到体验金验证码	体验金咨询
我收到邮箱邀请注册送38怎么申请	体验金咨询
体验金	体验金咨询
注册送彩金	体验金咨询
体验金输入不了卡号	体验金咨询
体验金收不到验证码	体验金咨询
没收到验证码	体验金咨询
体验金能玩哪些游戏	体验金咨询
体验金多少可以提款	体验金咨询
我体验金打到提款	体验金咨询
体验金打多少可以提款	体验金咨询
体验金游戏	体验金咨询
收不到验证码	体验金咨询
收不到验证码	体验金咨询
体验金，你是傻逼吗	体验金咨询
邮件特邀88彩金	体验金咨询
刚注册的会员，是不是要送88？	体验金咨询
注册送菜金吗	体验金咨询
注册送彩金吗	体验金咨询
刚注册的会员，是不是要送88？	体验金咨询
注册送菜金吗	体验金咨询
体验金多少能提款??	体验金咨询
体验金	体验金咨询
体验金可以玩什么	体验金咨询
注册送多少彩金	体验金咨询
体验金可以玩古怪猴子吗	体验金咨询
申请体验金收不到手机验证码	体验金咨询
特邀88	体验金咨询
我收到邮件特邀送我88彩金	体验金咨询
我要领取邮件特邀88彩金	体验金咨询
系统提示信息重复&银行卡重复	体验金咨询
第一次提款要完善资料	提款相关问题
第一次提款	提款相关问题
提款要打多少流水	提款相关问题
秒提到帐?	提款相关问题
提款密码忘了	提款相关问题
提款密码不记得	提款相关问题
提款的密码忘记了	提款相关问题
为什么无提款	提款相关问题
提款需要很久吗	提款相关问题
存到哪去了	提款相关问题
我要取消刚刚的提款	提款相关问题
怎么提款啊	提款相关问题
打多少可以提款	提款相关问题
打到多少可以提款	提款相关问题
提款要打多少可以	提款相关问题
取款失败了	提款相关问题
提款	提款相关问题
提款是秒到吗?	提款相关问题
提款失败了	提款相关问题
提款怎么这么久	提款相关问题
要在哪里提款	提款相关问题
取款密码	提款相关问题
提款密码	提款相关问题
取款密码是什么	提款相关问题
取款密码忘了	提款相关问题
提款的密码	提款相关问题
提款相关问题忘记了	提款相关问题
提现要好久	提款相关问题
我操他妈的提款到底给不给	提款相关问题
提款没到	提款相关问题
提款怎么取消了	提款相关问题
不能提款	提款相关问题
提款了没到	提款相关问题
我的提款操作怎么失败了	提款相关问题
取款密码	提款相关问题
取款密码问题	提款相关问题
提款怎么这么慢	提款相关问题
取款没到账	提款相关问题
我提款的钱怎么没有了	提款相关问题
取消我的提款	提款相关问题
我提款怎么老在审核	提款相关问题
我的提款操作怎么失败了	提款相关问题
提款没到帐	提款相关问题
反水发了没	返水咨询
如何查询我的返水	返水咨询
如何查询我的返水	返水咨询
自助返水领取不了	返水咨询
BBIN游戏有反水吗	返水咨询
我反水怎么不对	返水咨询
自主反水	返水咨询
系统反水要好久	返水咨询
AG真人返水多少	返水咨询
我的反水呢?	返水咨询
AG反水是什么时候派发	返水咨询
自助反水上一笔自足洗码审核中	返水咨询
我自助洗码怎么是0	返水咨询
怎么一直显示上一笔洗码自助审核中	返水咨询
无法输入银行卡	密保银行卡解绑
解绑银行卡	密保银行卡解绑
银行卡丢了	密保银行卡解绑
怎么输不了银行卡号	密保银行卡解绑
我是说为什么不能输入银行卡卡号	密保银行卡解绑
银行卡号输不进去	密保银行卡解绑
无法输入银行卡	密保银行卡解绑
银行卡怎么没办法输入	密保银行卡解绑
银行卡怎么不能输入	密保银行卡解绑
无法输入银行卡	密保银行卡解绑
哪里绑定银行卡?	密保银行卡解绑
银行卡不能输入	密保银行卡解绑
无法输入银行卡	密保银行卡解绑
我自助申请怎么选不了银行卡类型	密保银行卡解绑
我密保忘记了	密保银行卡解绑
无法输入银行卡	密保银行卡解绑
银行卡号忘记了	密保银行卡解绑
银行卡号忘记了	密保银行卡解绑
银行卡号忘记了	密保银行卡解绑
我要解绑密保我	密保银行卡解绑
我的银行卡号多少	密保银行卡解绑
论坛登不上	不能登录
论坛怎么进不去	不能登录
我找不到你们论坛在哪里	不能登录
论坛登不进去	不能登录
论坛坏了	不能登录
登不进去论坛	不能登录
进不到论坛	不能登录
论坛上不去	不能登录
论坛没办法登录	不能登录
论坛进不去	不能登录
论坛打不开	不能登录
网页打不开	不能登录
网页打不开	不能登录
网页一直打不开	不能登录
官网进不去	不能登录
网站进不去	不能登录
网页被狭持	不能登录
网页打不开	不能登录
网页被狭持	不能登录
官网进不去	不能登录
网页打不开	不能登录
官网不能登录	不能登录
我怎么登陆不上呢？	不能登录
为什么一定要使用谷歌浏览器用我手机自带的浏览器不可以吗？	不能登录
网站	不能登录
官网打不开	不能登录
我登入不了，说会员不存在	不能登录
登入的时后说我密码错误	不能登录
官网问题	不能登录
有网址吗	不能登录
没办法登入	不能登录
登入不了	不能登录
官网进不蓼	不能登录
官网打不开	不能登录
网站登不进去	不能登录
官网登不上去	不能登录
官网是好多？	不能登录
登入客户端，显示账号密码错误	不能登录
官网上不去	不能登录
网站为什么这么卡	不能登录
给我个官网网址	不能登录
官网是多少？	不能登录
索取官网网址	不能登录
官网太卡了	不能登录
网页打不开或官网进不去	不能登录
除了谷歌浏览器，还有什么浏览器可以使用	不能登录
网站发来	不能登录
网站好像上不去	不能登录
官网上不去	不能登录
官网多少	不能登录
索取官网网址	不能登录
晋级有优惠吗	VIP咨询
我不明白！vlp就是人！我们会员就不是人了吗？	VIP咨询
晋级了，晋级礼金呢	VIP咨询
成功晋级的礼金	VIP咨询
刚晋级了，怎么没有晋级礼金	VIP咨询
我刚刚晋级了有什么彩金吗	VIP咨询
怎么晋级	VIP咨询
VIP有什么好处	VIP咨询
哪边领免费筹码	VIP咨询
有生日礼金吗	VIP咨询
我想成为VIP	VIP咨询
帮我查询我现在可以晋级吗？	VIP咨询
我刚刚领了生日礼金怎么不见了啊	VIP咨询
领取免费筹码	VIP咨询
你好问一下我的生日礼金怎么领取	VIP咨询
生日礼金	VIP咨询
生日礼金	VIP咨询
没有找到苹果手机的二维码	app咨询
APP彩金多少可以提款	app咨询
app彩金	app咨询
APP	app咨询
不能下载APP	app咨询
PT客户端	app咨询
APP下载彩金	app咨询
APP哪里下载	app咨询
我下载APP无法领取	app咨询
苹果PT客户端	app咨询
DT客户端加什么	app咨询
我的app下载彩金从注册到现在都没有	app咨询
