千倍白倍在哪申请？	咨询当下相关活动
千倍百倍在哪申请	咨询当下相关活动
申请彩金132元	咨询当下相关活动
申请存款领红包	咨询当下相关活动
接你司电话领取彩金	咨询当下相关活动
刚接到你司电话，说领取我账号的什么彩金哟	咨询当下相关活动
有什么优惠	咨询当下相关活动
申请久安钱包下载彩金	咨询当下相关活动
电话通知我领一彩金	咨询当下相关活动
给你发邮箱可以送钱啊	咨询当下相关活动
领彩金	咨询当下相关活动
领存款优惠	咨询当下相关活动
申请存款领红包卷	咨询当下相关活动
下载了久安，要送彩金是吗	咨询当下相关活动
存款1000领取红包	咨询当下相关活动
你好啊七夕搭鹊桥这个活动中的神秘宝箱彩金需要多少倍流水啊谢谢	咨询当下相关活动
充值有彩金嘛	咨询当下相关活动
存100送50的优惠，要多少流水？	咨询当下相关活动
请问客服人员打电话跟我说的存款送红包的活动怎么领取	咨询当下相关活动
你好 存100不是领取8元红包吗？	咨询当下相关活动
申请，千百倍	咨询当下相关活动
还有什么彩金吗	咨询当下相关活动
签到彩金怎么用？	咨询当下相关活动
我的申请送的红包在哪里	咨询当下相关活动
申请优惠	咨询当下相关活动
存够二百送彩金	咨询当下相关活动
我问下签到额度咋用？	咨询当下相关活动
亲，送了我彩金56元，在那个里面的，麻烦你你给我	咨询当下相关活动
有56元彩金，送我的，客户打电话我的	咨询当下相关活动
申请单笔存款200送18活动	咨询当下相关活动
申请存款红包	咨询当下相关活动
上次接到你们的电话说我有彩金可以领	咨询当下相关活动
存50到118吗	咨询当下相关活动
呐这个签到彩金意思是我这个月内存款到多少钱就可以提还是当天	咨询当下相关活动
签到领取四元，一个月存多少钱才可以拿出来	咨询当下相关活动
下载久安钱包不是有彩金送吗？	咨询当下相关活动
申请单笔存款送彩金的活动	咨询当下相关活动
签到彩金怎么才能用	咨询当下相关活动
签到的彩金怎么用	咨询当下相关活动
存款送红包	咨询当下相关活动
存款送彩金	咨询当下相关活动
申请存款彩金	咨询当下相关活动
麻烦帮我申请下存200送18的彩金	咨询当下相关活动
你好我想问下会员日礼金找你领吗	咨询当下相关活动
接到电话让我过来领彩金	咨询当下相关活动
签到采金怎么兑换??	咨询当下相关活动
申请存款两百送18元红包	咨询当下相关活动
申请存款红包优惠券	咨询当下相关活动
申请存款红包	咨询当下相关活动
申请充值就送彩金	咨询当下相关活动
昨天接到你们电话说加我QQ提供优惠活动，怎么现在还没有加	咨询当下相关活动
下载怎么送彩金	咨询当下相关活动
申请存款红包	咨询当下相关活动
新用户，有什么优惠	咨询当下相关活动
千百倍奖金要什么申请	咨询当下相关活动
申请微信红包	咨询当下相关活动
申请充值福利	咨询当下相关活动
申请存100送彩金	咨询当下相关活动
存款送红包是不是？	咨询当下相关活动
收到邀请短信冲值50元到账118元怎么申请	咨询当下相关活动
领取账号专属彩金	咨询当下相关活动
132彩金怎么领取	咨询当下相关活动
注册满一年赠送彩金的活动是否还在继续	咨询当下相关活动
签到彩金怎么转换到主账户	咨询当下相关活动
不可以领彩金	咨询当下相关活动
收到邮件说送88怎么领取？	咨询当下相关活动
存就送优惠	咨询当下相关活动
我要申请存就送彩金	咨询当下相关活动
申请存100送8元优惠	咨询当下相关活动
不是30送28么	咨询当下相关活动
我下了久安钱包了，8彩金哪里领	咨询当下相关活动
我是收到手机邮箱。注册有132元红包	咨询当下相关活动
说的送的88的彩金呢？	咨询当下相关活动
每日单笔存款100摇筛子	咨询当下相关活动
收到邮件申请58彩金	咨询当下相关活动
领取久安钱包彩金	咨询当下相关活动
申请存款红包	咨询当下相关活动
现在充值就送钱活动还有吗	咨询当下相关活动
我邮件说找你领18	咨询当下相关活动
申请支付宝存款奖金	咨询当下相关活动
申请久安支付红包	咨询当下相关活动
邮箱收到信息送彩金	咨询当下相关活动
申请西天取经彩金	咨询当下相关活动
我领千百倍和存款红包	咨询当下相关活动
申请微信红包	咨询当下相关活动
你们刚才给我来电话，说送我活跃彩金，加微信，一直没加	咨询当下相关活动
有什么优惠	咨询当下相关活动
申请存款送彩金	咨询当下相关活动
充值就送钱活动	咨询当下相关活动
优惠没到	咨询当下相关活动
充值就送钱活动	咨询当下相关活动
充值就送钱	咨询当下相关活动
充值就送钱活动	咨询当下相关活动
有什么优惠可以参加	咨询当下相关活动
签到彩金	咨询当下相关活动
不能领签到	咨询当下相关活动
签到彩金不能领	咨询当下相关活动
签到彩金如何转出	咨询当下相关活动
如何领取存款彩金	咨询当下相关活动
存款100有什么优惠	咨询当下相关活动
充值奖励	咨询当下相关活动
这个月活动	咨询当下相关活动
申请充值奖励	咨询当下相关活动
有什么优惠	咨询当下相关活动
申请充值久送钱活动	咨询当下相关活动
你好，申请存款红包	咨询当下相关活动
申请久安钱包彩金	咨询当下相关活动
优惠活动	咨询当下相关活动
申请存款红包	咨询当下相关活动
用戶，你朋友领了，就差你开户送42无水提款，进zunbao005.com维心zunbao05领首存2百送2百5个红包。txH	咨询当下相关活动
申请西天取经	咨询当下相关活动
签到彩金怎么才能用	咨询当下相关活动
签到彩金怎么用	咨询当下相关活动
存就送怎么领	咨询当下相关活动
存送优惠	咨询当下相关活动
你好 存100不是领取8元红包吗？	咨询当下相关活动
捕鱼怎么充值的、	转账咨询
进入游戏不见余额	转账咨询
不能转账	转账咨询
DT要怎转帐	转账咨询
怎么额度转换？	转账咨询
转账里面SLOT是什么平台	转账咨询
按一建回归额度我的钱在哪里	转账咨询
SLOT是老虎机吗	转账咨询
要转换才能玩金花没	转账咨询
告诉我怎么转换平台	转账咨询
忘记账号了	账号解锁、忘记账号
解锁账户	账号解锁、忘记账号
忘记账号密码了	账号解锁、忘记账号
忘了账号密码了	账号解锁、忘记账号
帐号被禁用了	账号解锁、忘记账号
忘记账号和密码怎么找回	账号解锁、忘记账号
解锁账号	账号解锁、忘记账号
游戏账号冻结，	账号解锁、忘记账号
我的账号，怎么冻结了	账号解锁、忘记账号
我忘记账号了	账号解锁、忘记账号
账户冻结	账号解锁、忘记账号
你好，我找不到自己的账号了	账号解锁、忘记账号
我的帐号锁了	账号解锁、忘记账号
这个账号被锁了	账号解锁、忘记账号
帐号锁了	账号解锁、忘记账号
账号户名我写错了，我要禁用这个账号	账号解锁、忘记账号
我刚注册的账号忘了	账号解锁、忘记账号
记不住账号了	账号解锁、忘记账号
帮我账号解一下锁	账号解锁、忘记账号
忘记账号和密码	账号解锁、忘记账号
解冻pt	账号解锁、忘记账号
我的账号忘记了	账号解锁、忘记账号
忘记游戏帐号只记得手机	账号解锁、忘记账号
解锁账号	账号解锁、忘记账号
查一下我账号	账号解锁、忘记账号
忘记帐号	账号解锁、忘记账号
忘记帐号	账号解锁、忘记账号
找回账号	账号解锁、忘记账号
找帐号	账号解锁、忘记账号
忘记帐号	账号解锁、忘记账号
登录pt客户端账户被冻结	账号解锁、忘记账号
pt客户端账号冻结	账号解锁、忘记账号
pt账号被锁	账号解锁、忘记账号
客户端帐号冻结	账号解锁、忘记账号
你那里有没有香港六合彩	游戏咨询
你的平台有六合彩吗	游戏咨询
VR没有吗	游戏咨询
PT客户端登陆	游戏咨询
怎么登陆PT平台？	游戏咨询
我游戏里面没有声音	游戏咨询
pt客户端前缀加什么？	游戏咨询
麻烦你介绍两款可以玩的	游戏咨询
推荐几个出分高的游戏	游戏咨询
pt游戏前面加什么字母	游戏咨询
pt客服端前面加什么字母	游戏咨询
请问PT客户端帐号前加什么字母	游戏咨询
我想查询老虎机游戏	游戏咨询
有体育投注的？	游戏咨询
哪个出分	游戏咨询
哪个游戏出分	游戏咨询
DT哪个游戏出分	游戏咨询
什么游戏出分	游戏咨询
猴子不出分呢	游戏咨询
打那个游戏出分	游戏咨询
今天哪些游戏比较好打	游戏咨询
哪个游戏出分好	游戏咨询
我想玩儿百家乐	游戏咨询
我要玩儿包桌百家乐	游戏咨询
为什么我投注百家乐，押庄，赢了派彩金额不对啊	游戏咨询
体育怎么玩	游戏咨询
出分游戏	游戏咨询
真人游戏怎么玩	游戏咨询
你们游戏那个好？	游戏咨询
那个好玩？游戏	游戏咨询
出分游戏推荐几个	游戏咨询
目前出分最高的游戏是什么	游戏咨询
百家乐怎么玩	游戏咨询
我这个布法罗闪电战派彩错了	游戏咨询
赔付不对	游戏咨询
赔付不对	游戏咨询
SLOT是什么游戏	游戏咨询
pt客户端前面加什么	游戏咨询
沙巴体育	游戏咨询
体育怎么下注	游戏咨询
761棋牌	游戏咨询
MW大满贯	游戏咨询
平博体育	游戏咨询
泛亚电竞	游戏咨询
百家乐有吗	游戏咨询
百家乐怎么玩	游戏咨询
我不会玩百家乐啊	游戏咨询
百家乐有什么阿	游戏咨询
百家乐是什么	游戏咨询
百家乐好玩吗	游戏咨询
百家乐有什么	游戏咨询
你们有百家乐吗	游戏咨询
有百家乐吗	游戏咨询
百家乐没有吗	游戏咨询
我都玩百家乐	游戏咨询
百家乐怎么查记录	游戏咨询
推荐好玩的百家乐游戏	游戏咨询
体育有吗	游戏咨询
体育怎么玩	游戏咨询
我不会玩体育啊	游戏咨询
体育有什么阿	游戏咨询
体育是什么	游戏咨询
体育好玩吗	游戏咨询
体育有什么	游戏咨询
你们有体育吗	游戏咨询
有体育吗	游戏咨询
体育没有吗	游戏咨询
我都玩体育	游戏咨询
体育怎么查记录	游戏咨询
推荐好玩的体育游戏	游戏咨询
老虎机有吗	游戏咨询
老虎机怎么玩	游戏咨询
我不会玩老虎机啊	游戏咨询
老虎机有什么阿	游戏咨询
老虎机是什么	游戏咨询
老虎机好玩吗	游戏咨询
老虎机有什么	游戏咨询
你们有老虎机吗	游戏咨询
有老虎机吗	游戏咨询
老虎机没有吗	游戏咨询
我都玩老虎机	游戏咨询
老虎机怎么查记录	游戏咨询
推荐好玩的老虎机游戏	游戏咨询
彩票有吗	游戏咨询
彩票怎么玩	游戏咨询
我不会玩彩票啊	游戏咨询
彩票有什么阿	游戏咨询
彩票是什么	游戏咨询
彩票好玩吗	游戏咨询
彩票有什么	游戏咨询
你们有彩票吗	游戏咨询
有彩票吗	游戏咨询
彩票没有吗	游戏咨询
我都玩彩票	游戏咨询
彩票怎么查记录	游戏咨询
推荐好玩的彩票游戏	游戏咨询
电竞有吗	游戏咨询
电竞怎么玩	游戏咨询
我不会玩电竞啊	游戏咨询
电竞有什么阿	游戏咨询
电竞是什么	游戏咨询
电竞好玩吗	游戏咨询
电竞有什么	游戏咨询
你们有电竞吗	游戏咨询
有电竞吗	游戏咨询
电竞没有吗	游戏咨询
我都玩电竞	游戏咨询
电竞怎么查记录	游戏咨询
推荐好玩的电竞游戏	游戏咨询
捕鱼有吗	游戏咨询
捕鱼怎么玩	游戏咨询
我不会玩捕鱼啊	游戏咨询
捕鱼有什么阿	游戏咨询
捕鱼是什么	游戏咨询
捕鱼好玩吗	游戏咨询
捕鱼有什么	游戏咨询
你们有捕鱼吗	游戏咨询
有捕鱼吗	游戏咨询
捕鱼没有吗	游戏咨询
我都玩捕鱼	游戏咨询
捕鱼怎么查记录	游戏咨询
推荐好玩的捕鱼游戏	游戏咨询
老虎机游戏进去3到5秒它就显示无法加载,要么就是代码错误	游戏进不去
为什么dt的午夜之王玩不了	游戏进不去
当前游戏不可用	游戏进不去
bbin耍不起么？	游戏进不去
bbin玩不了？	游戏进不去
游戏增麽这么卡啊	游戏进不去
游戏还没完成就不转了增麽回事	游戏进不去
错误编码104	游戏进不去
First_Launch_Initialization	游戏进不去
无法进入pt游戏	游戏进不去
错误编码2	游戏进不去
免费游戏掉线了怎么办	游戏进不去
你们家能不能玩了	游戏进不去
BBIN不能下注	游戏进不去
不能投注	游戏进不去
怎么AG百家乐不能玩?	游戏进不去
你好 我的AG真人为什么一直加载不进去呀。我换了几个浏览器都不行	游戏进不去
为什么我进不去游戏	游戏进不去
MG玩不了	游戏进不去
玩不了游戏	游戏进不去
游戏掉线进不去	游戏进不去
Chrome□□□□□□□	游戏进不去
我mg游戏耍不起呢，显示119代码	游戏进不去
错误编码2	游戏进不去
Chrome□□□□□□□	游戏进不去
我问你怎么游戏这么卡	游戏进不去
游戏掉线进不去，或有未完成游戏	游戏进不去
怎么今天dt平台一点也不稳定半小时掉线快10次了	游戏进不去
免费游戏掉线	游戏进不去
PT怎么不能进	游戏进不去
mg怎么不能进了	游戏进不去
png怎么不能玩了	游戏进不去
dt怎么不能进了	游戏进不去
qt怎么不能进了	游戏进不去
ag怎么不能进了	游戏进不去
捕鱼怎么不能进了	游戏进不去
体育怎么不能进了	游戏进不去
bbin怎么不能进了	游戏进不去
彩票怎么不能进了	游戏进不去
手机号码打错了可以改吗	修改账号资料
怎么绑定姓名	修改账号资料
修改手机	修改账号资料
我开户时手机号码和现在的号码不一样	修改账号资料
我想换一下手机号码行吗？	修改账号资料
我换了手机号码	修改账号资料
你好，我想查一下我的邮箱号，时间太长了，记不清楚了	修改账号资料
时间太长邮箱号不记得了，怎么查	修改账号资料
邮箱号记不清楚了怎么办	修改账号资料
用户名谢平我只输了谢一个姓，就不小心碰到了确定，现在我要怎么更改	修改账号资料
你好，我想问一下，我注册账号的时候，在填写姓名的时候不小心多点了个字母，能改吗	修改账号资料
更换手机	修改账号资料
注册手机丢失可以更换吗？	修改账号资料
我注册的时候号码填错了	修改账号资料
我输入资料时把电话号码写错了一个数字怎么办	修改账号资料
修改手机号码	修改账号资料
可以更换手机号码吗	修改账号资料
修改手机号	修改账号资料
电话号码可以修改吗	修改账号资料
电话号码能修改吗	修改账号资料
我想把电话号码改改	修改账号资料
你好，忘了登录密码	忘记密码
密码不对	忘记密码
我的密码忘记了	忘记密码
登录密码忘记了	忘记密码
登录密码忘了	忘记密码
重置密码	忘记密码
我忘记密码	忘记密码
忘记密码的	忘记密码
我忘了登录密码	忘记密码
通过密保找回密码怎么显示错的	忘记密码
我密码忘记了，通过手机找回的短信密码显示错的	忘记密码
你好我把密码忘记了	忘记密码
邮箱有。能找到密码吗	忘记密码
登录密码忘了	忘记密码
密码错误	忘记密码
密码锁了	忘记密码
帮忙我找一下密码好吗	忘记密码
你好我密码忘了	忘记密码
帮我把密码改一下	忘记密码
密码忘记了	忘记密码
忘记密码怎么办	忘记密码
登录密码忘记了	忘记密码
帮我重置下密码	忘记密码
忘记密码但是手机号忘记了邮箱不使用了怎么办	忘记密码
找回密码	忘记密码
注册送彩金吗	体验金咨询
那可以换邮箱申请开户彩金吗吗？	体验金咨询
欢迎来尊宝：注册马上领彩金<br/>新号福利：<br/>新注册送132彩金，无限制，满388即可提款无上限老虎机百家乐体育捕鱼<br/>首存50到账108，无提款上线<br/>开户网址：https://www.zunbao129.com	体验金咨询
申请邮箱特邀注册彩金	体验金咨询
体验金怎么使用？？？	体验金咨询
注册送132怎样申请	体验金咨询
你们网站发邮件给我说 喊我开户送132啊	体验金咨询
你好，怎么收不到验证码	体验金咨询
注册送彩金？	体验金咨询
注册送彩金？	体验金咨询
我注册成功了为什么没有送呢	体验金咨询
新会员送体验金	体验金咨询
体验金	体验金咨询
不能领体验金	体验金咨询
无法领体验金	体验金咨询
无法领开户金	体验金咨询
如何领体验金	体验金咨询
app彩金电话短信收不到	体验金咨询
申请注册送132彩金	体验金咨询
注册彩金	体验金咨询
你好，我新注册的，不是绑定银行卡就可以给体验金嘛？为啥我的没有	体验金咨询
注册送彩金	体验金咨询
收到邮件注册领取132彩金	体验金咨询
注册是送88么	体验金咨询
注册松彩金吗	体验金咨询
老虎机体验账户里面的钱怎么用	体验金咨询
帮我查下我能领到体验金吗不能我难得下app了	体验金咨询
我这么没有app体验金	体验金咨询
申请app彩金说我资讯重复什么意思	体验金咨询
注册就送88元？	体验金咨询
开户彩金	体验金咨询
注册有送彩金吗	体验金咨询
注册送88彩金啊	体验金咨询
不是注册都送的是88彩金吗	体验金咨询
收到邮件说注册送88	体验金咨询
注册送132彩金吗？	体验金咨询
申请开户彩金	体验金咨询
申请132体验金	体验金咨询
我刚注册的，领APP彩金怎么系统提示我资料重复，怎么办？	体验金咨询
手机信息注册领58彩金	体验金咨询
申请注册彩金	体验金咨询
注册礼金在吗领取	体验金咨询
新来的有奖励吗	体验金咨询
我刚注册的账号怎么申请体验金他说我什么信息重复什么意思	体验金咨询
为什么我没有体验金	体验金咨询
你好我问下新注册首冲送88彩金对吗	体验金咨询
查询注册时间	体验金咨询
查询注册时间	体验金咨询
注册送彩金吗	体验金咨询
注册就送彩金么？	体验金咨询
注册有132的优惠可以领取吗？	体验金咨询
注册送我六十八	体验金咨询
收到短信注册送42	体验金咨询
申请开户送42彩金	体验金咨询
我手机收不到验证码	体验金咨询
开户送彩金	体验金咨询
你那边有没有六合彩	体验金咨询
你好 请问我的提款申请为什么没通过 ?	提款相关问题
提款没到账	提款相关问题
提款没到	提款相关问题
提款未到帐	提款相关问题
提款没到	提款相关问题
提款没到账	提款相关问题
提现怎么老师已取消	提款相关问题
我问一下现在提款要核实账号?	提款相关问题
麻烦你帮我看一下我的提款，什么时候能到账	提款相关问题
怎么我出款这么久还没有出款？	提款相关问题
第一次提款多久到账	提款相关问题
你好，我提款了100元，怎么还没到账哦？	提款相关问题
提款怎么好慢	提款相关问题
提款怎么取消？？	提款相关问题
怎么提个款半天不审核	提款相关问题
给我出款啊	提款相关问题
怎么提款不到账	提款相关问题
怎么设定提款密码	提款相关问题
提款没到	提款相关问题
忘记取款密码	提款相关问题
为什么我的提款被取消	提款相关问题
我的提款为什么给取消了？	提款相关问题
提款已执行，钱没到帐	提款相关问题
不申请优惠，本金是不是不用打流水就可以提现啊？	提款相关问题
怎么不能提款	提款相关问题
我提款了半天一直没到账	提款相关问题
提款沒到帳	提款相关问题
提款密码忘了	提款相关问题
提现怎么显示取消？	提款相关问题
我提款	提款相关问题
我昨晚的提款，还没有到账？	提款相关问题
怎么提现	提款相关问题
提现不到账	提款相关问题
提款密码多少？	提款相关问题
久安提款多久到账	提款相关问题
提款要等多久？	提款相关问题
提款还没到？	提款相关问题
我的取款还没到	提款相关问题
我说提款取消了	提款相关问题
取款怎么还没到账	提款相关问题
提款没到	提款相关问题
提现半个小时没到	提款相关问题
我提款不能到账？	提款相关问题
看看我的提款	提款相关问题
帮我取消提款	提款相关问题
取款一般需要多久到账啊？	提款相关问题
提款一小时了还是待审核	提款相关问题
提钱需要审核多少时间	提款相关问题
你好，帮我查一下我的PT平台流水	刷新流水
你给看下吧  是不是流水不够	刷新流水
给我刷新一下我的流水	刷新流水
客服PT哪些游戏不算流水	刷新流水
给我刷新一下pt	刷新流水
麻烦你帮我把pt流水刷新一下	刷新流水
帮我刷新流水PT	刷新流水
刷新一下中心钱包流水	刷新流水
请问我打了一个小时的游戏了为什么一分流水也没有？	刷新流水
问下，你们的流水算法是只算投资额嘛？	刷新流水
麻烦刷新一下流水，很久没有更新了	刷新流水
刷新一下流水	刷新流水
更新下pt流水，我要自助洗吗	刷新流水
什么是流水	刷新流水
投注不正确	刷新流水
pt流水	刷新流水
帮我更新PT流水，我要提款	刷新流水
你好，麻烦你帮我查查我账号参加过首存没有	首存咨询
首充10送多少	首存咨询
PT首存，什么游戏都可以玩是吗	首存咨询
我已经自助申请首存了	首存咨询
刚才我冲了一百不是送一百吗？	首存咨询
请问老虎机首存优惠是不是	首存咨询
首存10元送多少阿	首存咨询
首存10元送多少？优惠彩金阿	首存咨询
我第一次申请提款，系统自动取消了，第二次提款半小时还在审核	首存咨询
首充有什么优惠	首存咨询
首充有什么奖励	首存咨询
首充送吗	首存咨询
首充送钱吗	首存咨询
我刚刚首充，怎么没有送钱	首存咨询
首充不是送百分百吗	首存咨询
首充没送吗	首存咨询
请帮查下我这个卡号绑定相互没有	密保银行卡解绑
帮我查一下我绑定的银行卡号是多少？	密保银行卡解绑
密保重置	密保银行卡解绑
我昨天存款了280，怎么没有救援金了？	救援金咨询
救援金要几倍流水才可以下	救援金咨询
随时玩你们的平台那天答应送红包优惠券怎么不送	红包咨询
申请红包优惠券你处理一下	红包咨询
我红包里的钱怎么用	红包咨询
红包代会码错误	红包咨询
你们发邮件给我说可以送我28特邀彩金	红包咨询
哈啰，HI，哇塞~您号竟然能拿8-588荭苞，+唯心zunbao05存50给118红包拿荭苞网之:zunbao005点com哟。2Tt	红包咨询
领红包	红包咨询
我要申请转运红包，从昨天到现在输的太多了	红包咨询
申请转运红包	红包咨询
邮箱特邀vip送彩金不	红包咨询
红包代码错误	红包咨询
我要红包	红包咨询
给我红包	红包咨询
我要红包彩金	红包咨询
你好，帮忙申请个转运红包	红包咨询
红包优惠券几倍流水提款	红包咨询
求一个转运包	红包咨询
申请转运红包	红包咨询
红包优惠倦怎么写金额	红包咨询
红包优惠	红包咨询
电话说找你领红包	红包咨询
6214831285432628 红包代码没法用	红包咨询
红包优惠代码错误	红包咨询
我的红包	红包咨询
转运红包	红包咨询
红包代码未审核，叫联系在线客服审核	红包咨询
领取特邀128	红包咨询
申请一个转运红包	红包咨询
刚刚客服给我电话说给了优惠红包，来领	红包咨询
给我个转运红包吧？	红包咨询
有红包吗	红包咨询
给红包	红包咨询
整天输钱有没有红包	红包咨询
你好，昨天我申请了个转运红包，怎么没给呢	红包咨询
可以给我红包吗	红包咨询
麻烦申请个转运红包	红包咨询
我的红包代码为什么用不了呢	红包咨询
专属客服红包	红包咨询
能不能送我个红包啊。这两天都输了	红包咨询
我的申请送的红包在哪里	红包咨询
拉人给你们给不给提成	好友推荐
介绍朋友怎么介绍	好友推荐
你好 咱们的qq客服的qq号是多少	官网及账号问题
你们的网站怎么注册不了啊？	官网及账号问题
账号注册	官网及账号问题
账号怎么注册	官网及账号问题
没法注册	官网及账号问题
被代理欺骗了	官网及账号问题
你们微信客服是那个	官网及账号问题
查询注册问题	官网及账号问题
我想做你们代理	官网及账号问题
你们电话打过来叫加qq。发过去又不接受好友	官网及账号问题
查询注册问题	官网及账号问题
怎么发图片了	官网及账号问题
怎么载图了	官网及账号问题
你好请问怎么联系到QQ客服	官网及账号问题
帮我查一下什么时候注册的	官网及账号问题
您好请问贵公司需要广告推广吗？	官网及账号问题
10大bc推广方式！！1：支付宝推广2：苹果推imesage3:短信群发4：微信裂变5：微信小程序6：bc论坛po文7：论坛广告位8:微信朋友圈推广9：抖音信息群发10：微博私信联系QQ:2846700197	官网及账号问题
帮我查一下注册时间	官网及账号问题
你好 咱们的qq客服的qq号是多少	官网及账号问题
怎么注册	官网及账号问题
您好！请问贵公司需要做广告推广吗？	官网及账号问题
怎么注册	官网及账号问题
注册时间	官网及账号问题
请问有qq客服吗？我加个qq，以后方便问事	官网及账号问题
查看看我账号注册时间	官网及账号问题
查看看我帐号注册时间	官网及账号问题
你好，请问贵公司广告部或者市场部联系方式方便提供吗？我这边是做线上营销推广的。	官网及账号问题
我注册总是显示该用户存在	官网及账号问题
我們是游戏商CQ9，我们想把游戏接到你们的平台上，请問相関代理，方便之后联络吗?	官网及账号问题
怎么开户	官网及账号问题
怎么注册	官网及账号问题
注册账号	官网及账号问题
刚刚你们公司的电话客服打电话给我我手机的声音话筒坏了所以我刚刚接了电话没说话能不能拜托一下你帮我跟刚刚那个电话客服解释一下	官网及账号问题
我注册新的你们又说我多账户	官网及账号问题
查询一下，是不是有注册一年了	官网及账号问题
查询注册时间	官网及账号问题
注册时间	官网及账号问题
我想问问我是什么时候注册的	官网及账号问题
帮我看一下我什么时候注册的	官网及账号问题
查看看我帐号注册时间	官网及账号问题
查询注册时间	官网及账号问题
我想查注册时间	官网及账号问题
我什么时候注册的	官网及账号问题
我要申请会员日彩金，帮我查注册日期	官网及账号问题
申请周年日，注册时间啥时	官网及账号问题
我要申请周年彩金，帮我查啥时注册的	官网及账号问题
帮我查下注册时间	官网及账号问题
查询注册日期	官网及账号问题
注册时间	官网及账号问题
查下注册时间	官网及账号问题
查下注册日期	官网及账号问题
我的注册日	官网及账号问题
怎么发截图	官网及账号问题
怎么发图片	官网及账号问题
查询注册问题	官网及账号问题
账号怎么注册	官网及账号问题
没法注册	官网及账号问题
我要发截图	官网及账号问题
我要发图片	官网及账号问题
图片怎么发	官网及账号问题
图片发不出去	官网及账号问题
图片发不出来	官网及账号问题
我不会截图	官网及账号问题
我不会发图片	官网及账号问题
无法注册	官网及账号问题
vr彩票有返水吗	返水咨询
VR没有返水吗	返水咨询
为什么我的投注记录与洗码的和实际不一样	返水咨询
你好，BBIN电子老虎机的投注不可以参与自助反水吗？	返水咨询
bbin的有效投注怎么没有反水呢？	返水咨询
bbin老虎机的投注可以自助反水吗？	返水咨询
bbin返水怎么领	返水咨询
怎么领反水	返水咨询
你好，我的pt游戏怎么会没有反水	返水咨询
洗吗审核中	返水咨询
我的返水呢?	返水咨询
你好，我昨天晚上投注的bbin电子游戏怎么没有反水呢？	返水咨询
咋冲的钱还不到	存款相关问题
存款不到	存款相关问题
充值末到账	存款相关问题
充值还没到账啊	存款相关问题
存了20怎么账户没有	存款相关问题
转账了20但是游戏账户里没到	存款相关问题
我充的钱还没到喃	存款相关问题
存款没到账	存款相关问题
充值没到账。	存款相关问题
我用支付宝存款	存款相关问题
存款没到账	存款相关问题
支付宝转账未到账	存款相关问题
刚用支付宝转账了，但是在页面上忘记点了我已转账成功	存款相关问题
充值没有到账	存款相关问题
你们还有什么存款方式	存款相关问题
支付宝转账你们已经关闭了	存款相关问题
存款没有到账	存款相关问题
花呗能不能存款	存款相关问题
花呗充值	存款相关问题
QQ存了30	存款相关问题
我支付宝转账了何时到账？	存款相关问题
充值活跃不够什么情况？	存款相关问题
怎么100块钱不能存了	存款相关问题
不能存钱了	存款相关问题
我充值不到账	存款相关问题
微信转账没到账	存款相关问题
我微信给你们转过去钱了	存款相关问题
我支付宝充值成功了 但游戏里还没到账啊	存款相关问题
网银转账怎能还没有到账阿	存款相关问题
我刚刚支付宝转账到曾涛银行卡上怎么没到账？	存款相关问题
我刚刚用微信转账100已经成功了怎么还没有到账号	存款相关问题
我已经存款，并显示已经到账，为什么账号没有钱	存款相关问题
左春娟，我用支付宝给你尾号3847的青岛银行银行卡转了50.00元钱，预计08-1424:00前到账，请到时候确认银行卡余额明细。	存款相关问题
存个款还说我活跃度不够	存款相关问题
存款没到	存款相关问题
微信存款未到账	存款相关问题
你好 支付宝怎么不能存款啊	存款相关问题
我的支付宝秒存为啥还没到账	存款相关问题
支付宝存款不到账	存款相关问题
支付宝秒存没到账	存款相关问题
存款没到账	存款相关问题
你好，帮我查询一下我的存款怎么还没到账	存款相关问题
我支付宝存款没到账	存款相关问题
支付宝转账没到账	存款相关问题
我支付宝转帐还没到	存款相关问题
我在支付宝存款没有到帐	存款相关问题
我的钱怎么没到账	存款相关问题
麻烦帮我处理存款	存款相关问题
存款不到	存款相关问题
存款没到账	存款相关问题
充值没到账	存款相关问题
扫吗成功没有到账	存款相关问题
怎么入款不到帐？	存款相关问题
我充的钱咋还没到账	存款相关问题
我微信给你转过去钱了	存款相关问题
你好，现在支付宝转账会马上到账吗？	存款相关问题
我微信给你们银行卡转过去钱了，我账户上没到账	存款相关问题
梅二亮，我用支付宝给你尾号4757的招商银行银行卡转了100.00元钱已经到账了，确认下银行卡余额明细哦。	存款相关问题
我用微信秒存的钱还没到账	存款相关问题
我用微信秒存的钱还没到	存款相关问题
我刚刚用支付宝存款已经成功了	存款相关问题
我的存款没到账	存款相关问题
我的钱怎么没到账怎么还没到账？？？	存款相关问题
充值没到账	存款相关问题
存款没有到账	存款相关问题
为什么右100只有95到帐	存款相关问题
充值没到账	存款相关问题
微信支付可以吗	存款相关问题
存款没到账呀	存款相关问题
存款没到账	存款相关问题
可以支付宝存款吗	存款相关问题
我存款没到	存款相关问题
支付宝扫码	存款相关问题
你家那存款怎么会有手续费啊	存款相关问题
我冲了100没到	存款相关问题
存不上钱	存款相关问题
存款没到账	存款相关问题
昨天有笔支付宝转账成功没到账	存款相关问题
存款没有到账	存款相关问题
我充值了，在主页没看到资金啊	存款相关问题
久安钱包怎么用	存款相关问题
还没到账	存款相关问题
支付宝没到账	存款相关问题
支付宝转账	存款相关问题
支付宝转账没到账	存款相关问题
现在支付宝转账到账这么慢吗？	存款相关问题
我支付宝转帐没到帐	存款相关问题
你好我的存款没到账	存款相关问题
存款没有到账	存款相关问题
什么是久安	存款相关问题
存款没到账	存款相关问题
存款什么最好	存款相关问题
支付宝转账怎么还没到账	存款相关问题
存款为到账	存款相关问题
存款怎么没的到账	存款相关问题
怎么存款啊	存款相关问题
存款不到帐	存款相关问题
充值成功未到账	存款相关问题
你好，请速度处理我的存款。谢谢	存款相关问题
存款了…成功支付了	存款相关问题
支付宝转账没到帐	存款相关问题
我的存款咋还没有啊	存款相关问题
充值没到账	存款相关问题
充值款怎么没到账	存款相关问题
存款未到	存款相关问题
支付宝转账还没到账	存款相关问题
支付宝秒存没到账	存款相关问题
支付宝存款怎么还不到账啊	存款相关问题
我钱存了怎么没到分	存款相关问题
充值没有到账	存款相关问题
我的支付宝存款一直没到账	存款相关问题
充值没到账哦	存款相关问题
微信支付怎么这么慢没到账	存款相关问题
支付宝扫码未到账	存款相关问题
怎么存款没到	存款相关问题
我云闪付支付40没有到	存款相关问题
你好我的存款怎么还没有到账呢	存款相关问题
你好，我用支付宝转账的钱怎么没有到账呢	存款相关问题
怎么没有微信转账	存款相关问题
不能微信转账吗	存款相关问题
微信冲了500没到账	存款相关问题
这扫码钱也不随时到账吗？	存款相关问题
存款怎么存	存款相关问题
刚我在线支付190，怎么还没到	存款相关问题
次充是什么	次存咨询
次充是什么	次存咨询
次次冲是什么	次存咨询
次次充是什么	次存咨询
次次存是什么	次存咨询
笔笔存是什么	次存咨询
笔笔充是什么	次存咨询
笔笔存笔笔送	次存咨询
次次存次次送	次存咨询
我这里停电了，来不及关闭pt客户端。现在用手机登录提示我账号已登录，联系在线客服处理	不能登录
网页打不开	不能登录
怎么会员不存在呢	不能登录
你们网止是多少	不能登录
PT客户端登不进	不能登录
你好我PT客户端刚才上电脑的，现在下线了，但是手机版客户端登录不了，麻烦你给关闭多窗口，谢谢！	不能登录
电脑版网站多少	不能登录
把官网地址发给我	不能登录
你们官网网址是多少	不能登录
我这里停电了，来不及关闭PT客户端。现在手机登录提示我已经登录，联系在线客服处理	不能登录
缓存，换浏览器，都试了	不能登录
我进的太阳城怎么会是尊宝	不能登录
我登入出问题	不能登录
游戏无法登入	不能登录
网站被狭持	不能登录
尊宝网站	不能登录
网站进不去	不能登录
生日禮金	VIP咨询
我的生日礼金忘记了领，过了几天，可以领吗，	VIP咨询
生日彩金没领能补发一个吗	VIP咨询
生日礼盒	VIP咨询
请问没有生日礼金那	VIP咨询
领取生日礼金	VIP咨询
如何下载app	app咨询
我下好了aqq为什么领不到彩金	app咨询
领取APP下载彩金	app咨询
下不了aqq	app咨询
我下官网aqq	app咨询
Aqq网页打不开	app咨询
Aqq下不了	app咨询
下载PT客户端进不去	app咨询
你好，AP下载彩金是不是不能玩三倍猴子咯？	app咨询
玩我呢，下载APP彩金又来个账号重复，没有就算了，忽悠人好玩啊，好了谢谢	app咨询
APP彩金领取	app咨询
下载app怎么送彩金	app咨询
申请APP彩金	app咨询
电脑版客户端在哪里下载？怎么也没有找到，谢谢	app咨询
有PT电脑版客户端下载吗？	app咨询
下载PT客户端电脑版	app咨询
登录pt客户端账户被冻结	app咨询
下载aqq送彩金吗	app咨询
下载手机PT客户端	app咨询
app链接给我一下	app咨询
app下载链接发给我，推荐给朋友	app咨询
我这么没app彩金	app咨询
我app没彩金	app咨询
下载app彩金无法领取	app咨询
app彩金可不可以玩大蓝	app咨询
app怎么登账号	app咨询
为何我下载了APP却申请不了彩金呢	app咨询
在哪下载app	app咨询
pt登录器下载不了	app咨询
下载app可以申请彩金吗	app咨询
APP已下载银行卡已绑好	app咨询
填写领取APP下载彩金真实姓名项无法填写	app咨询
怎么下载手机客户端pt	app咨询
下载地址	app咨询
app我没看见有礼金	app咨询
你好，App彩金页面怎么打不开呢	app咨询
你好，我网站可以登我账号。App就不行阿。提示没有账号	app咨询
发个pt下载地址给我	app咨询
ptAPP更新不能下载怎么办	app咨询
下载九安钱包的链接发给我	app咨询
下载客户端	app咨询
申请APP彩金	app咨询
下不了aqq	app咨询
Aqq网页打不开	app咨询
PT怎么不能登了	app咨询
申请app下载金	app咨询
申请APP下载金	app咨询
申请aqq下载金	app咨询
申请下载aqq	app咨询
qpp下载彩金	app咨询
下不了app	app咨询
app打不开	app咨询
pt客户端打不开	app咨询
dt客户端打不开	app咨询
pt客户端不能下载	app咨询
dt客户端不能下载	app咨询
下不了pt客户端	app咨询
下不了dt客户端	app咨询
