签到彩金不能用吗	咨询当下相关活动
签到彩金现在不能玩吗	咨询当下相关活动
你们有什么论坛活动	咨询当下相关活动
签到怎么提款不了	咨询当下相关活动
签到想提款	咨询当下相关活动
请问怎么申请千百倍无限之战的活动？	咨询当下相关活动
签到	咨询当下相关活动
签到	咨询当下相关活动
APP朋友圈有什么优惠吗	咨询当下相关活动
今天有什么活动吗	咨询当下相关活动
本月的优惠活动有什么	咨询当下相关活动
本月的优惠活动有什么	咨询当下相关活动
APP朋友圈有什么优惠吗	咨询当下相关活动
请问怎么申请千百倍无限之战的活动？	咨询当下相关活动
冰块活动	咨询当下相关活动
转账了但是PT里没分	转账咨询
我的存款不知道转入什么游戏平台了	转账咨询
我的钱转进游戏后不见了	转账咨询
我户内转账的钱不见了	转账咨询
要转到PT的钱不见了	转账咨询
我户内转账的钱不见了	转账咨询
转账转不了	转账咨询
账号密码都忘记了	账号解锁、忘记账号
登陆账号忘了	账号解锁、忘记账号
账号忘记了	账号解锁、忘记账号
忘记账号	账号解锁、忘记账号
忘记账号了	账号解锁、忘记账号
我的用户名忘记了	账号解锁、忘记账号
我的账号忘记了	账号解锁、忘记账号
用户名忘记了	账号解锁、忘记账号
登录帐号忘了	账号解锁、忘记账号
忘记账号	账号解锁、忘记账号
忘记账号	账号解锁、忘记账号
你妹的我说如果是你老母的老母，账号忘记能不能解	账号解锁、忘记账号
查体育的注单	游戏咨询
我刚刚下的体育注单哪看	游戏咨询
体育投注怎么看	游戏咨询
我刚刚的球赛注单哪看	游戏咨询
你们有体育吗	游戏咨询
在沙巴体育的投注单怎么查	游戏咨询
你家没有体育平台吗	游戏咨询
你家有体育平台吗	游戏咨询
糖果派对	游戏咨询
连环夺宝	游戏咨询
你们有糖果派对吗	游戏咨询
你们有连环夺宝吗	游戏咨询
你听过糖果派对吗	游戏咨询
你听过连环夺宝吗	游戏咨询
你知道糖果派对吗	游戏咨询
糖果派对在哪里	游戏咨询
连环夺宝在哪里	游戏咨询
糖果派对哪里玩	游戏咨询
连环夺宝哪里玩	游戏咨询
你知道连环夺宝吗	游戏咨询
糖果派对在哪个平台	游戏咨询
连环夺宝在哪个平台	游戏咨询
赔付问题	游戏咨询
我要查赔付	游戏咨询
赔付不正确	游戏咨询
昨天的三倍猴子赔付错了	游戏咨询
我想问赔付问题	游戏咨询
我想问一下赔付	游戏咨询
赔付怎么不对啊	游戏咨询
你可以帮我看一下赔付吗	游戏咨询
帮我算一下赔付	游戏咨询
刚刚的赔付有点问题	游戏咨询
你们有糖果派对吗	游戏咨询
你们有连环夺宝吗	游戏咨询
有什么热门游戏	游戏咨询
有什么好玩的游戏	游戏咨询
你们有bbin的游戏吗	游戏咨询
你们有没有试玩呀	游戏咨询
提供试玩的帐号吗	游戏咨询
你们老虎机怎么试玩	游戏咨询
我从其他平台来的，给个试玩吧	游戏咨询
试玩帐号怎么申请	游戏咨询
我想要先试玩看看	游戏咨询
可以申请试玩吗	游戏咨询
先试玩在考虑	游戏咨询
没有试玩我就不要了	游戏咨询
别家都可以试玩，你们家给不给	游戏咨询
哪些游戏好打	游戏咨询
年年有余今天出分吗	游戏咨询
DT客户端加什么	游戏咨询
出分	游戏咨询
我想查询游戏的赔付问题	游戏咨询
登入游戏要加什么前缀	游戏咨询
账号前面加什么	游戏咨询
用什么前缀	游戏咨询
出分游戏推荐	游戏咨询
推荐出分游戏	游戏咨询
操	游戏咨询
什么出分游戏	游戏咨询
有什么出分游戏	游戏咨询
出分游戏都不会吗	游戏咨询
怎么玩不了pt游戏	游戏进不去
我在使用pt客户端玩游戏进不去	游戏进不去
PT游戏不能玩	游戏进不去
MG游戏不能玩	游戏进不去
DT游戏不能玩	游戏进不去
PNG游戏不能玩	游戏进不去
QT游戏不能玩	游戏进不去
TTG游戏不能玩	游戏进不去
AG游戏不能玩	游戏进不去
体育游戏不能玩	游戏进不去
EA游戏不能玩	游戏进不去
EBET游戏不能玩	游戏进不去
N2LIVE游戏不能玩	游戏进不去
泛亚游戏不能玩	游戏进不去
平博游戏不能玩	游戏进不去
OG游戏不能玩	游戏进不去
HYG捕鱼游戏不能玩	游戏进不去
PTSW游戏不能玩	游戏进不去
PYSKY游戏不能玩	游戏进不去
BBIN游戏不能玩	游戏进不去
761游戏不能玩	游戏进不去
MW游戏不能玩	游戏进不去
钱来捕鱼游戏不能玩	游戏进不去
为什么我mg电子 不朽情愿进不去啊	游戏进不去
怎么打不开游戏	游戏进不去
PT怎么不能玩了	游戏进不去
MG怎么不能玩了	游戏进不去
DT不能玩	游戏进不去
我MG不能玩游戏	游戏进不去
游戏一直断	游戏进不去
游戏一直不能玩	游戏进不去
游戏一直登不进去	游戏进不去
PT不能游戏	游戏进不去
PT怎么玩不了	游戏进不去
PT开不了	游戏进不去
PT怎么开不了	游戏进不去
PT不能玩	游戏进不去
PT怎么动不了	游戏进不去
PT点不开	游戏进不去
NT不能玩	游戏进不去
NT怎么开不了	游戏进不去
NT怎么玩不了	游戏进不去
NT怎么不能玩	游戏进不去
NT怎么动不了	游戏进不去
NT点不开	游戏进不去
PTSKY不能玩	游戏进不去
PTSKY点不开	游戏进不去
PTSKY怎么开不了	游戏进不去
PTSKY怎么玩不了	游戏进不去
PTSKY怎么动不了	游戏进不去
PTSKY怎么不能玩	游戏进不去
DT玩不了啊	游戏进不去
DT不能玩	游戏进不去
DT点不开	游戏进不去
DT怎么开不了	游戏进不去
DT怎么动不了	游戏进不去
DT怎么不能玩	游戏进不去
MG怎么动不了	游戏进不去
MG点不开	游戏进不去
MG怎么不能玩	游戏进不去
MG怎么开不了	游戏进不去
MG玩不了啊	游戏进不去
MG不能玩	游戏进不去
PNG不能玩	游戏进不去
PNG点不开	游戏进不去
PNG怎么开不了	游戏进不去
PNG怎么动不了	游戏进不去
PNG怎么不能玩	游戏进不去
PNG怎么玩不了	游戏进不去
我进不去游戏了，玩不了了	游戏进不去
我想玩MG但进去没余额	游戏进不去
我MG不能玩游戏	游戏进不去
您好，我想玩MG游戏，但进去游戏却不能玩，怎么回事?	游戏进不去
pt游戏进不去了	游戏进不去
我的pt客户端进不去	游戏进不去
我游戏打不开	游戏进不去
游戏进不去	游戏进不去
我的注册姓名输入错误	修改账号资料
我的注册电话输入错误	修改账号资料
我的注册邮箱输入错误	修改账号资料
我要修改注册资料	修改账号资料
我的注册姓名输入错误	修改账号资料
我想要修改姓名	修改账号资料
注册	修改账号资料
我电话号码怎么修改啊	修改账号资料
系统在维护么？	系统维护状况说明
系统在维护么？	系统维护状况说明
忘记密码	忘记密码
我忘记密码了	忘记密码
收不到密码	忘记密码
自助找回收不到密码	忘记密码
我忘记密码了	忘记密码
没有收到新密码	忘记密码
我忘记密码了	忘记密码
密码忘记了怎么办	忘记密码
忘记密码	忘记密码
怎么收不到验证码啊	体验金咨询
收不到验证码	体验金咨询
一直收不到验证码	体验金咨询
收不到你们的验证码	体验金咨询
接收不到app彩金验证码	体验金咨询
我收不到验证码	体验金咨询
下载app手机验证，收不到验证码	体验金咨询
收不到验证码呀	体验金咨询
收不到验证码怎么办？	体验金咨询
我现在接收不到验证码怎么办	体验金咨询
申请app彩金收不到验证码	体验金咨询
为什么手机收不到验证码？	体验金咨询
我的app彩金还是收不到验证码	体验金咨询
收不到验证码哦	体验金咨询
可是收不到验证码	体验金咨询
手机收不到验证码	体验金咨询
下载app领取彩金手机收不到验证码	体验金咨询
收到短信邀请送68	体验金咨询
邮箱收到注册送36到88	体验金咨询
新注册送彩金是不是	体验金咨询
你们网站注册送88彩金是吗	体验金咨询
申请注册彩金	体验金咨询
还有注册彩金吗？	体验金咨询
注册奖金在哪儿领	体验金咨询
体验金什么时候能领取	体验金咨询
开户彩金怎么领取	体验金咨询
收到邮件注册送体验金	体验金咨询
注册送彩金申请	体验金咨询
体验金不能玩什么游戏	体验金咨询
无法输入银行卡	体验金咨询
我自助申请怎么选不了银行卡类型	体验金咨询
体验金多少能提款	体验金咨询
体验彩金有吗	体验金咨询
体验金多少钱	体验金咨询
這注册彩金	体验金咨询
体验金	体验金咨询
申请体验金收不到手机验证码	体验金咨询
8-88彩金	体验金咨询
体验金	体验金咨询
体验金	体验金咨询
体验金送多少	体验金咨询
体验金收不到验证码	体验金咨询
体验金多少能提款	体验金咨询
刚刚提现了一笔 什么时候能到？	提款相关问题
我刚提现了2000 怎么还没到账	提款相关问题
打多少可以提款	提款相关问题
提款密码忘了	提款相关问题
提款密码不记得	提款相关问题
取款密码忘了	提款相关问题
提款的密码	提款相关问题
提款的密码忘记了	提款相关问题
提款要多久	提款相关问题
一般提款是需要多久办理呢	提款相关问题
取款	提款相关问题
我的提款没有到账	提款相关问题
我要红包	提款相关问题
我中奖了我要提款	提款相关问题
我的提款怎么还没有到账	提款相关问题
我的提款怎么还没有到账	提款相关问题
我的提款操作怎么失败了	提款相关问题
我的提款怎么还没有到账	提款相关问题
提款没到	提款相关问题
反水几啪	提款相关问题
提款還不出	提款相关问题
体验金提款	提款相关问题
体验金多少钱能提款	提款相关问题
取消提款	提款相关问题
怎么没办法提款啊	提款相关问题
不能提款？是个什么状况啊？您跟小宝说说~ [link submit='上一笔秒提审核中']1.上一笔	提款相关问题
帮我刷一下投注额	刷新流水
帮我刷一下水	刷新流水
看一下现在投注多少了	刷新流水
帮我刷新一下流水	刷新流水
可以查一下我现在的投注吗	刷新流水
帮我看一下投注到了没	刷新流水
打码量多少	刷新流水
怎么查打码	刷新流水
我要查打码量	刷新流水
我现在打码量多少了	刷新流水
我现在打码多少了	刷新流水
打码量在哪里看	刷新流水
打码要怎么查	刷新流水
请帮我刷新下流水	刷新流水
查流水	刷新流水
请帮我刷新下流水	刷新流水
请帮我刷新下流水	刷新流水
请帮我刷新下流水	刷新流水
第一笔存款有送吗	首存咨询
首次存款有什么优惠么	首存咨询
首次存款有什么优惠么	首存咨询
我想申请首存	首存咨询
首存有什么优惠么	首存咨询
首存送多少	首存咨询
密保问题忘记怎么办	密保银行卡解绑
解除银行卡，从新绑定	密保银行卡解绑
我的卡号多少	密保银行卡解绑
帮我查下卡号	密保银行卡解绑
我的银行卡号多少	密保银行卡解绑
看一下我的卡号	密保银行卡解绑
我想解绑卡	密保银行卡解绑
我要解绑密保	密保银行卡解绑
如何解绑银行卡	密保银行卡解绑
解除银行卡	密保银行卡解绑
救援金给好少，都不够赢	救援金咨询
救援金	救援金咨询
救援金什么时候发	救援金咨询
救援金什么时候发	救援金咨询
我的救援金为什么这么少	救援金咨询
救援金需要多少倍流水	救援金咨询
我的救援金怎么没给	救援金咨询
救援金什么时候发	救援金咨询
怎么没有救援金	救援金咨询
我的救援金怎么没有	救援金咨询
我想领取救援金	救援金咨询
我输钱了 有红包吗	红包咨询
特邀红包	红包咨询
红包	红包咨询
申请活跃红包	红包咨询
红包代码错误	红包咨询
如何领取转运红包	红包咨询
如何领取特邀红包	红包咨询
如何领取转运红包	红包咨询
为什么我无法使用存送优惠券	红包咨询
有优惠彩金吗?	红包咨询
我的转运红包啥时到	红包咨询
特邀彩金	红包咨询
帮我申请个红包	红包咨询
如何领取特邀彩金	红包咨询
给我红包	红包咨询
给个红包	红包咨询
红包	红包咨询
我怎么申请好友推荐呢	好友推荐
怎么样才会有好友彩金	好友推荐
怎么清缓存阿	官网及账号问题
怎么清除缓存	官网及账号问题
缓存怎么清	官网及账号问题
缓存怎么清除	官网及账号问题
我的专属客服呢	官网及账号问题
我的专属客服是谁	官网及账号问题
谁是专属客服	官网及账号问题
专属客服	官网及账号问题
我的微信客服	官网及账号问题
我的客服微信号	官网及账号问题
给我专属客服微信号	官网及账号问题
专属客服都不回话	官网及账号问题
专属客服上班了吗	官网及账号问题
专属客服黑名单我	官网及账号问题
专属客服黑单我	官网及账号问题
专属客服不回话	官网及账号问题
专属客服不理我	官网及账号问题
更换专属客服	官网及账号问题
专属客服微信号	官网及账号问题
专属客服QQ号	官网及账号问题
专属客服有QQ吗	官网及账号问题
专属客服有扣扣吗	官网及账号问题
专属客服的扣扣	官网及账号问题
给我专属客服的扣扣	官网及账号问题
怎么清除缓存	官网及账号问题
如何清除缓存	官网及账号问题
清缓存	官网及账号问题
怎么清缓存	官网及账号问题
教我清缓存	官网及账号问题
不会清缓存	官网及账号问题
我不会清缓存	官网及账号问题
不会清除缓存	官网及账号问题
邮箱是什么格式	官网及账号问题
我注册账号为什么手机被已被使用了？	官网及账号问题
我注册账号提示我的手机号有注册过是怎么回事啊	官网及账号问题
我是第一次注册怎么说我注册过	官网及账号问题
代理有没有生日礼金	官网及账号问题
市场部没有在线客服吗	官网及账号问题
已经清除缓存了	官网及账号问题
已经使用谷歌了	官网及账号问题
我已经清缓存啦，还是不行	官网及账号问题
我已经换谷歌了，还是不行	官网及账号问题
我用的就是谷歌	官网及账号问题
我刚刚已经清缓存啦	官网及账号问题
我早就换谷歌了	官网及账号问题
我早就清缓存了	官网及账号问题
已经清缓存了	官网及账号问题
已经用谷歌了	官网及账号问题
您好，我们是做广告代发的~ 需要推广吗？	官网及账号问题
专属客服的微信	官网及账号问题
清除缓存	官网及账号问题
清除缓存了	官网及账号问题
我已经清除缓存了	官网及账号问题
缓存都清了	官网及账号问题
早就清除缓存了	官网及账号问题
早就清缓存了	官网及账号问题
都清几次缓存了	官网及账号问题
是要清多少次缓存	官网及账号问题
已经使用谷歌	官网及账号问题
早就用谷歌了	官网及账号问题
我用的就是谷歌	官网及账号问题
是谷歌	官网及账号问题
我用的谷歌	官网及账号问题
我早就用谷歌了	官网及账号问题
我是用谷歌	官网及账号问题
专属客服	官网及账号问题
我的专属客服是谁	官网及账号问题
我的专属客服有吗	官网及账号问题
给我专属客服的微信	官网及账号问题
专属客服的微信	官网及账号问题
我有专属客服吗	官网及账号问题
专属客服是谁	官网及账号问题
没见过专属客服	官网及账号问题
我的专属客服刚刚打电话来	官网及账号问题
注册账号不成功	官网及账号问题
论坛登不上	官网及账号问题
论坛怎么进不去	官网及账号问题
我找不到你们论坛在哪里	官网及账号问题
论坛登不进去	官网及账号问题
论坛坏了	官网及账号问题
登不进去论坛	官网及账号问题
进不到论坛	官网及账号问题
我想要再注册一个账号可以吗	官网及账号问题
能重新注册吗	官网及账号问题
这账号我不要了，可以再注册一个吗	官网及账号问题
这账号我不要了，可以再申请一个吗	官网及账号问题
账号可以重新注册一个吗	官网及账号问题
账号可以重新申请一个吗	官网及账号问题
注册不了	官网及账号问题
可以重新注册吗	官网及账号问题
要怎么清缓存	官网及账号问题
我不会清缓存	官网及账号问题
查询专属客服	官网及账号问题
叫客服加我微信	官网及账号问题
能不能教我清缓存	官网及账号问题
账号要怎么注册，你能不能教我	官网及账号问题
叫客服加我微信	官网及账号问题
注册	官网及账号问题
要怎么成为代理	官网及账号问题
可以帮忙注册账号吗	官网及账号问题
前缀是什么	官网及账号问题
代理佣金问题	官网及账号问题
我想加入代理	官网及账号问题
注册好难噢	官网及账号问题
代理	官网及账号问题
广告	官网及账号问题
帮忙注册账号吗	官网及账号问题
查询专属客服	官网及账号问题
上一笔返水没有审核	返水咨询
反水	返水咨询
pt投注后，点自助反水，提示无投注	返水咨询
帮我审核返水	返水咨询
我不能自助返水了	返水咨询
帮我审核上笔返水	返水咨询
帮我审核上笔返水	返水咨询
返水说没审核	返水咨询
自助返水不能了	返水咨询
不能返水了	返水咨询
不能自助返水了	返水咨询
返水	返水咨询
我怎么没有领取到返水	返水咨询
存款没到	返水咨询
上笔返水审核中	返水咨询
微信付款钱什么时候到	存款相关问题
怎么不可以支付了？	存款相关问题
我刚刚存了款却没到账	存款相关问题
微信支付咋还不能存款了？	存款相关问题
我刚刚在你家存的钱咋还不到账啊	存款相关问题
QQ支付咋老是存不了	存款相关问题
支付宝账号存款还没到账	存款相关问题
为什么微信还不可以转账？	存款相关问题
你们能用花呗吗	存款相关问题
有久安吗	存款相关问题
久安钱包怎么用	存款相关问题
花呗不能存吗?	存款相关问题
京东白条可以存吗	存款相关问题
存到哪去了	存款相关问题
未到账	存款相关问题
存款	存款相关问题
我的存款	存款相关问题
久安存款没有到账	存款相关问题
为什么微信转账不能存款	存款相关问题
我为什么不能存款	存款相关问题
我为什么不能存款	存款相关问题
我在存款时被提示活跃度不足	存款相关问题
我想取消存款订单	存款相关问题
我想取消存款订单	存款相关问题
存款没到啦	存款相关问题
存款没到帐	存款相关问题
请问有什么存款方式	存款相关问题
没到账	存款相关问题
下午充的点卡现在还没到	存款相关问题
点卡现在还没到	存款相关问题
微信转账	存款相关问题
存款为什么不到帐	存款相关问题
怎么存款不了	存款相关问题
存款	存款相关问题
未到账	存款相关问题
我问你存款	存款相关问题
存款手续费	存款相关问题
存款会和有手续费	存款相关问题
存款为何有手续费	存款相关问题
存款不到	存款相关问题
存款每到	存款相关问题
存款	存款相关问题
支付宝	存款相关问题
存款未到	存款相关问题
次存有什么优惠么	次存咨询
我为什么无法申请次存	次存咨询
我为什么无法申请次存	次存咨询
官网进不去	不能登录
怎么说会员不存在	不能登录
官网进不去	不能登录
说什么会员不存在	不能登录
怎么会员不存在	不能登录
网页打不开	不能登录
有网址吗	不能登录
官网进不去	不能登录
网页进不去	不能登录
官网网址	不能登录
除了谷歌浏览器，还有什么浏览器可以使用？	不能登录
已经尝试使用谷歌浏览器，还是无法进入，可以用什么浏览器呢？	不能登录
网址	不能登录
官网怎么登不进去了	不能登录
登入不了	不能登录
官网不能登录	不能登录
领取每月免费筹码	VIP咨询
vip彩金怎么领不了	VIP咨询
免费筹码怎么领不了？	VIP咨询
生日彩金怎么领	VIP咨询
晋级礼金和免费筹码啥时候给呀	VIP咨询
VIP有什么优惠	VIP咨询
晋级有优惠吗	VIP咨询
我刚刚晋级了有什么彩金吗	VIP咨询
VIP有哪些优惠	VIP咨询
怎么领不到免费筹码?	VIP咨询
系统晋级	VIP咨询
晋级	VIP咨询
怎么领不到免费筹码?	VIP咨询
自助晋级	VIP咨询
我今天生日	VIP咨询
如何领取免费筹码	VIP咨询
怎么申请生日礼金	VIP咨询
大侠~生日礼金目前已经可以自助领取了噢~请您点击<a target='_blank' class='	VIP咨询
怎么申请生日礼金	VIP咨询
你们网站app在哪里下载	app咨询
扫描手机app下载不了	app咨询
下载app彩金为什么领取不了	app咨询
你们APP怎么下载	app咨询
APP怎么下载	app咨询
我下载APP无法领取	app咨询
下载捕鱼客户端	app咨询
下载EBET手机客户端	app咨询
我没有办法下载APP	app咨询
苹果PT客户端	app咨询
下载官网APP	app咨询
PT客户端	app咨询
尊宝APP	app咨询
我是用手机APP	app咨询
