pt有没有电脑端	app咨询
苹果手机可以下载pt 客服端么	app咨询
客户端下载不了啊	app咨询
PT手机客户端下载地址	app咨询
苹果app无法下载	app咨询
app下载网址	app咨询
怎么下载手机app	app咨询
请问下载手机APP在那里下载	app咨询
在哪下载app	app咨询
怎么下载app	app咨询
下载app地址发给我	app咨询
APP怎么下载	app咨询
PT客服端在哪下载，登陆加什么	app咨询
手机App怎么下载	app咨询
下载app	app咨询
下载app在那里	app咨询
app下载不了	app咨询
app怎么下的	app咨询
下载APP网址	app咨询
下载app也有彩金送？	app咨询
App用不了啊	app咨询
app下载地址	app咨询
怎么下载aqq	app咨询
下载app网址多少	app咨询
下载app链接	app咨询
app怎么下	app咨询
发个手机app链接	app咨询
app怎么下载，找不到下载的地方	app咨询
把下载app链接发我	app咨询
麻烦一下把下载官网APP的链接发给我好吗	app咨询
给我aqq下载	app咨询
请问申请下载app领取彩金  在哪里申请啊？	app咨询
app下载后可以领彩金吗	app咨询
我想知道app在哪下载	app咨询
下载app怎么下载	app咨询
手机客户端下载方式	app咨询
苹果手机app哪里下载	app咨询
我要下载客户端pt的电脑玩	app咨询
给我一个电脑客户端下载连接PT的	app咨询
有没有下载app的礼金么	app咨询
怎么下载客户端	app咨询
DT手机APP怎么进不去了	app咨询
app地址 打不开	app咨询
PT游戏客户端	app咨询
手机app	app咨询
app哪里下载	app咨询
pt客户端网址	app咨询
发个app下载链接给我	app咨询
申请APP彩金	app咨询
申请下载APP彩金	app咨询
晋级有优惠吗	VIP咨询
升级不送彩金了？	VIP咨询
vip是怎么办理的	VIP咨询
申请生日礼金	VIP咨询
为什么我的生日到了    生日彩金没有吗？	VIP咨询
哪里领取晋级彩金	VIP咨询
申请生日礼金	VIP咨询
我的会员筹码怎么领取不了	VIP咨询
我已经晋级超级vip礼金怎么领取	VIP咨询
网页被狭持	不能登录
网页被劫持	不能登录
给个域名	不能登录
您好网站是多少	不能登录
怎么登陆登不上	不能登录
帮我查下干嘛登不进去呀？	不能登录
我的账号登陆不上了	不能登录
为什么我账号登不起呢	不能登录
网址多少	不能登录
手机最新网址多少	不能登录
还有其他备用网址吗	不能登录
无法登录论坛麻烦帮我同步下	不能登录
我无法登录论坛	不能登录
同步下论坛麻烦您。无法上论坛	不能登录
我登陆说账号不存在	不能登录
登录不了，是前面要加什么吗	不能登录
我下载pt客户端我登录密码和帐号都对为什么上不去	不能登录
我下载pt客户端怎么登录不了啊？	不能登录
网址是多少？	不能登录
我要网站，发我一下	不能登录
网页是多少。麻烦告诉下	不能登录
最新网址 是多少	不能登录
发下网址来	不能登录
PT手机app怎么登不进去	不能登录
PT手机版怎么登不进去	不能登录
登录pt客户端怎么显示账户或密码错误	不能登录
网址是多少？	不能登录
论坛上不去，密码不对	不能登录
管网网址	不能登录
我的账号怎么不存在了	不能登录
给发个电脑网址	不能登录
手机浏览器网址多少	不能登录
你们电脑网站是多少	不能登录
网站多少	不能登录
还有其他备用网址吗	不能登录
网址给我个	不能登录
pt客户端怎么登不进去呀	不能登录
电脑进什么网址	不能登录
你们官网多少	不能登录
我的账号登不进去了怎么办	不能登录
官网网址发下	不能登录
怎么登不上去啊	不能登录
论坛不能登	不能登录
谷歌去哪里下载	不能登录
推荐一个浏览器	不能登录
推荐一个浏览器	不能登录
怎么在论坛上的转盘登陆时登陆不上	不能登录
只能用谷歌浏览器吗	不能登录
谷歌浏览器	不能登录
只能用谷歌浏览器吗	不能登录
只能用谷歌浏览器吗	不能登录
官网登不上去	不能登录
只能用谷歌浏览器吗	不能登录
为什么只能用谷歌浏览器	不能登录
官网地址	不能登录
论坛登不进去	不能登录
新的网址发过来一下	不能登录
现在游戏网站发给我	不能登录
我想绑卡怎么不让我绑啊？	密保银行卡解绑
银行卡绑错了,给我解绑	密保银行卡解绑
我绑的银行卡掉了，能帮我解绑换下卡号吗	密保银行卡解绑
银行卡解绑	密保银行卡解绑
银行卡解绑	密保银行卡解绑
怎么换银行卡	密保银行卡解绑
帮忙注销一下银行账户	密保银行卡解绑
帮我把密保问题取消一下	密保银行卡解绑
怎么解绑银行卡	密保银行卡解绑
为什么不能绑卡	密保银行卡解绑
忘记密保问题怎么修改密保	密保银行卡解绑
帮我把农业银行删掉	密保银行卡解绑
重新邦定银行卡	密保银行卡解绑
我得银行卡没绑定过啊为什么不能绑定	密保银行卡解绑
不可以绑定银行卡？	密保银行卡解绑
怎么查询自己银行卡信息	密保银行卡解绑
怎么解绑银行卡？	密保银行卡解绑
我忘了密保问题了	密保银行卡解绑
我的密保，忘记是啥了	密保银行卡解绑
银行卡可以改吗	密保银行卡解绑
无法输入银行卡	密保银行卡解绑
我的密保忘了怎么办	密保银行卡解绑
我的pt怎么不能自助反水	返水咨询
反水怎么还没有	返水咨询
反水没有反	返水咨询
AG反水什么时候到	返水咨询
我BBIN怎么没反水呢？	返水咨询
你们网站百家乐反水是什么时候	返水咨询
反水能直接提现不	返水咨询
刷新下洗码	返水咨询
我的账号怎么没有返水呢	返水咨询
自助反水现在可以反吗	返水咨询
反水哪里领取？	返水咨询
返水什么时间到	返水咨询
怎么PT没有投注记录，我要反水	返水咨询
自助反水   提示无投注记录  麻烦帮我刷新一下	返水咨询
这个反水不给我	返水咨询
你们的返水是什么时候返	返水咨询
你们这个返水是什么时间	返水咨询
你们到底给不给出款	提款相关问题
我提的现怎么还没到	提款相关问题
我提了款为什么还没有到账了	提款相关问题
请问提款多久到账	提款相关问题
怎么提不起款啊？	提款相关问题
我怎么不能提款呢？	提款相关问题
为什么提不了现金啊	提款相关问题
不能提款吗	提款相关问题
为何取款失败	提款相关问题
为什么现在提款不了	提款相关问题
为什么现在不能提款？	提款相关问题
提款显示已执行怎么还没到卡的	提款相关问题
我要提款请问怎么提	提款相关问题
请问我的提款怎么要审批这么久？	提款相关问题
请帮我查询下为什么我的提款审核要那么久？	提款相关问题
请帮我查询下我的提款申请	提款相关问题
请帮我查询下我的提款为什么要等这么久？	提款相关问题
我取款怎么一直都是待审核	提款相关问题
提款为啥不成功	提款相关问题
提现要多久	提款相关问题
你好我半小时前就提款了怎么还没有到账啊	提款相关问题
我的提款怎么还没有到账	提款相关问题
最低提款多少	提款相关问题
提款还没有到账怎么回事	提款相关问题
提款审核	提款相关问题
你好，我的取款密码忘了，帮我查一下	提款相关问题
提款审核了怎么半天不出款啊	提款相关问题
提款怎么又是半天不到	提款相关问题
提款到账能不能快点	提款相关问题
提款怎么每次都这么不到账	提款相关问题
出款50分钟怎么还没到账	提款相关问题
怎么提款这么久还在审核当中呢	提款相关问题
我刚才提款怎么还没到账	提款相关问题
为什么我申请提款你们不出款	提款相关问题
怎么提款了半个小时还没到账	提款相关问题
麻烦把出款取消订单	提款相关问题
我的取款已审核 但是怎么还没出款啊	提款相关问题
怎么我的取款已取消啊？	提款相关问题
怎么还是提现这么久都没到账？	提款相关问题
我刚刚的提款为什么给我取消了	提款相关问题
提款需要多久	提款相关问题
提款怎么还没有到账	提款相关问题
我的提款怎么到现在还没审核好	提款相关问题
最低取款多少	提款相关问题
您好我提款一直待审核能不能帮我看看	提款相关问题
我的取款为什么还不到账啊？	提款相关问题
我这个怎么不能退款了	提款相关问题
我的取款为什么被取消了？	提款相关问题
为什么提款到账这么慢呢	提款相关问题
提款没到账	提款相关问题
我的提款密码忘记了，怎么找回	提款相关问题
提现没到账	提款相关问题
我的提款为什么还没有到呢。	提款相关问题
我的提款怎么还没到	提款相关问题
提款为什么给我取消了	提款相关问题
提款要多长时间?	提款相关问题
提款一直都是待审核	提款相关问题
我的提款怎么又取消了	提款相关问题
提现帮忙出下款	提款相关问题
我刚才提款怎么还不到	提款相关问题
干嘛提款审核这么久还没得呢？	提款相关问题
提款什么时候到账	提款相关问题
提款密码忘了	提款相关问题
怎么我提现了还不到帐？	提款相关问题
我提现怎么还不到帐的?	提款相关问题
请问取款多长时间到我银行卡里	提款相关问题
我有一笔提款转移至审核中	提款相关问题
为什么以前取钱的密码不能用了	提款相关问题
提款要多久到账啊	提款相关问题
刚设置完取款密码为什么还是取不了	提款相关问题
提款怎么一直在审核？	提款相关问题
提款怎么一直在审核中	提款相关问题
出款未到帐	提款相关问题
为什么不能提款	提款相关问题
打多少可以提款	提款相关问题
提款没到帐	提款相关问题
取款密码是什么	提款相关问题
可以取消提款吗	提款相关问题
提款已审核20分钟了.怎么还不执行呢	提款相关问题
我提款怎么还没到账	提款相关问题
提款已审核.怎么还不执行	提款相关问题
你好请问一下我秒速提款为什么一个小时了还没到	提款相关问题
你好请问一下我秒速提款为什么一个小时了还没到	提款相关问题
你这个取款怎么取的	提款相关问题
提款审核下	提款相关问题
你们这个游戏取款是怎么取	提款相关问题
我怎么取不了款了？	提款相关问题
提款审核下	提款相关问题
我要取款是怎么弄的	提款相关问题
我怎么不能提款	提款相关问题
提的钱什么时候到账	提款相关问题
注册有没活动	体验金咨询
注册送体验金吗？	体验金咨询
哪里申请体验金	体验金咨询
注册送彩金	体验金咨询
不是说新注册领彩金吗，怎么没有呢？	体验金咨询
邮件说注册彩金58有吗	体验金咨询
是不是开户就送彩金	体验金咨询
请问开户体验金在哪领取？	体验金咨询
新人注册送彩金吗？	体验金咨询
注册彩金怎么领取呢？	体验金咨询
注册送18彩金嘛	体验金咨询
申请注册菜金	体验金咨询
不是注册送彩金吗？怎么不行	体验金咨询
请领体验金18多少才能提款	体验金咨询
注册送彩金	体验金咨询
注册送58彩金怎么申请	体验金咨询
请问我申请了的体验金 8元打到多少可以取款？	体验金咨询
我收到邮件说你们网站注册送58元彩金	体验金咨询
领取注册彩金	体验金咨询
体验金怎么领	体验金咨询
注册送88活动有吗	体验金咨询
查询一下我还能不能申请体验金？	体验金咨询
注册彩金有没有游戏限制	体验金咨询
那个体验金在哪里领	体验金咨询
申请新用户注册彩金	体验金咨询
怎么领体验金	体验金咨询
注册菜金有何要求	体验金咨询
请问现在注册有免费彩金吗？？	体验金咨询
我从未注册过这个网站，为什么显示我已经使用过体验金？	体验金咨询
为什么我申请注册彩金一直显示系统繁忙	体验金咨询
我申请体验金短信发了怎么说没有收到我呢	体验金咨询
是不是新注册送88	体验金咨询
怎么绑银行卡时不能选择银行卡类型	体验金咨询
我已经注册怎么没送彩金	体验金咨询
申请开户彩金	体验金咨询
为什么显示未收到短信	体验金咨询
我领取彩金，短信发了。显示的没收到	体验金咨询
app那彩金发完信息显示收不到是啥意思	体验金咨询
为什么我用注册手机发送短信，系统提示未收到短信呢	体验金咨询
你好为什么我领取不到体验金啊	体验金咨询
申请注册88注册彩金	体验金咨询
APP领取不了彩金，说我信息重复	体验金咨询
注册送88那个怎么申请	体验金咨询
自助体验金如何领取啊	体验金咨询
注册送彩金怎么领	体验金咨询
体验金怎么领不了	体验金咨询
申请开户彩金的时候银行卡验证的时候银行验证怎么点不动	体验金咨询
申请体检金	体验金咨询
没有体验金吗	体验金咨询
我想咨询下，注册送礼金	体验金咨询
申请体验金呢	体验金咨询
怎么领彩金的时候输入不了银行	体验金咨询
领体验金的，为什么选不了银行类型	体验金咨询
你好注册有39彩金吗	体验金咨询
注册送彩金了	体验金咨询
注册有彩金吗？	体验金咨询
怎么领取不了体验金	体验金咨询
开户体验金要多少才可以提款	体验金咨询
申请注册彩金	体验金咨询
下载app注册送彩金要怎么申请	体验金咨询
注册送体验金吗?	体验金咨询
我申请下载app注册送彩金的活动。但是说信息重复	体验金咨询
咱们是不是有那个体验金啊	体验金咨询
我在申请彩金的时候，银行卡那里怎么填不起	体验金咨询
体验金多少提现	体验金咨询
我新注册的注册送彩金	体验金咨询
下载了有没有注册彩金	体验金咨询
注册送彩金吗	体验金咨询
邮箱特邀注册送体验金	体验金咨询
怎么发短信领体验金发了短信总是说没有发送	体验金咨询
新会员  第一次进你们网站  为什么领取体验金提示 信息重复  无法领取	体验金咨询
收到你家短信说注册送彩金是吗	体验金咨询
申请app下载体验金	体验金咨询
申请注册送78彩金	体验金咨询
收到邮件开户送68	体验金咨询
申请注册优惠	体验金咨询
注册app彩金怎么领取啊	体验金咨询
昨天申请的注册送彩金的怎么没有送啊	体验金咨询
没有注册彩金申请吗？	体验金咨询
注册送不送彩金	体验金咨询
我申请自助体验金，为什么系统提示，信息重复，未申请通过是怎么回事	体验金咨询
申请注册送38优惠	体验金咨询
新用户给彩金	体验金咨询
申请新会体验金	体验金咨询
开户送的彩金怎么送？	体验金咨询
新用户有彩金么？	体验金咨询
申请新会员体验金	体验金咨询
注册不是说送体验金吗	体验金咨询
自助奖金收不到短信验证	体验金咨询
开户送分吗，咋没送	体验金咨询
新注册送38元体验金	体验金咨询
我申请注册体验金为啥说我银行信息存在，根本就不存在	体验金咨询
申请体验金说银行卡重复，不可能重复	体验金咨询
绑定不了银行卡怎么办，怎么领体验金	体验金咨询
体验金100就能提现吗	体验金咨询
请问开户就送怎么领取	体验金咨询
我申请体验金怎么不行	体验金咨询
怎么领取新注册彩金	体验金咨询
注册不是不体验金吗	体验金咨询
收到邮箱特邀，注册送彩金是吗	体验金咨询
新注册彩金咋领	体验金咨询
注册送金币吗	体验金咨询
送体验金	体验金咨询
注册送彩金吗	体验金咨询
体验金不能玩哪些游戏	体验金咨询
体验金不能玩哪些游戏	体验金咨询
怎么领体验金	体验金咨询
怎么收不到验证码	体验金咨询
没办法领体验金	体验金咨询
注册彩金	体验金咨询
领体验金为什么信息重复	体验金咨询
申请注册体验金	体验金咨询
我收到短信说注册送83	体验金咨询
在哪里申请注册彩金呀美女	体验金咨询
不是注册送彩金吗，我怎么没有	体验金咨询
体验金申请	体验金咨询
注册体验金怎么领	体验金咨询
体验金	体验金咨询
体验金能玩哪些游戏	体验金咨询
体验金游戏限制	体验金咨询
体验金赢得不能提现吗？？	体验金咨询
您好我手机刚收到信息注册送68	体验金咨询
注册彩金有什么游戏限制	体验金咨询
注册不起来	官网及账号问题
我注册说我信息有重复	官网及账号问题
我手机号被人注册了怎么办	官网及账号问题
我代理账号忘记密码了	官网及账号问题
注册不了	官网及账号问题
我刚注册完，怎么就上不了	官网及账号问题
为什么注册不了	官网及账号问题
微信专员微信号多少	官网及账号问题
市场部的什么时候上班	官网及账号问题
您好 请问贵司需要广告精准推广吗？	官网及账号问题
我的账号被禁用，可以重新申请吗	官网及账号问题
请问申请代理 需要多久	官网及账号问题
美女在哪里注册	官网及账号问题
怎么注册不了账号	官网及账号问题
我的手机号码从没有注册过，为什么显示已经被注册过？	官网及账号问题
请问专属客服微信多少	官网及账号问题
刚想注册个账号密码的！！但不知道为什么说我输入的手机号已存在	官网及账号问题
招不招代理	官网及账号问题
这老虎机佣金能提款不	官网及账号问题
代理链接是多少	官网及账号问题
有微信公众号吗	官网及账号问题
只能用谷歌吗	官网及账号问题
你好 怎么注册	官网及账号问题
注册新号显现信息重复 什么意思	官网及账号问题
手机版的代理如何登入	官网及账号问题
请问邀请人那个彩金需要多久才能到账呢	好友推荐
推荐朋友得优惠吗?	好友推荐
推荐人彩金怎么申请	好友推荐
救援什么时间发放？	救援金咨询
救援有什么条件？	救援金咨询
为什么我救援还没发啊？	救援金咨询
我今天救援金有吗？查一下	救援金咨询
我怎么今天没有救援金呢？	救援金咨询
救援金派发了吗？	救援金咨询
我救援金没啊	救援金咨询
怎么领取救援金？	救援金咨询
我怎么没有救援金	救援金咨询
救援金第二天什么时候领？	救援金咨询
救援金怎么申请	救援金咨询
我昨天前天充了那么多钱怎么没有救援金呀	救援金咨询
我存款200元，救援金为什么没有呢	救援金咨询
我怎么没有救援金呢	救援金咨询
救援金怎么还没有	救援金咨询
怎么领不了救助金啊	救援金咨询
如何领取救援金啊	救援金咨询
救援金	救援金咨询
救援金什么时候派发	救援金咨询
救援金现在一半何时发？	救援金咨询
你好，我玩了3000左右。怎么救援金没有呀	救援金咨询
救援金什么时候发	救援金咨询
救援金为什么还没有派发	救援金咨询
救援金几点发	救援金咨询
今天的救援金还没派发吗	救援金咨询
请问自助救援金什么时候发	救援金咨询
救援金几点派发	救援金咨询
我怎么没有救援金？	救援金咨询
救援金是什么时候派送	救援金咨询
这个救援金怎么没有	救援金咨询
救援金怎么领	救援金咨询
我申请救援金	救援金咨询
银行维护要维护多久喃	系统维护状况说明
提示【维护中】	系统维护状况说明
提示【维护中】	系统维护状况说明
怎么能解绑手机号	修改账号资料
绑定的手机号可以修改吗？	修改账号资料
我能不能改电话号码  在绑定的号码没用了	修改账号资料
修改电话	修改账号资料
修改手机号码	修改账号资料
邮箱怎么改	修改账号资料
我刚刚注册完填个人资料时名字写错了，改不过来了，怎么办	修改账号资料
修改手机号码	修改账号资料
我留的电话号码错了，你帮我改一下	修改账号资料
我以前绑的手机卡丢了怎么办，能改吗	修改账号资料
请问怎么修改手机号码啊	修改账号资料
我名字搞错了，怎么修改不了	修改账号资料
可以更改手机号吗	修改账号资料
我注册时把手机号填错了  怎么能修改啊？	修改账号资料
电话号码能修改一下吗	修改账号资料
姓名怎么添加不上去	修改账号资料
怎么换电话号码	修改账号资料
可以更换手机号码吗	修改账号资料
手机号码换可以换吗	修改账号资料
我要修改名字和电话怎么修改	修改账号资料
可以解绑手机号吗	修改账号资料
怎么绑定姓名	修改账号资料
要绑定姓名怎么做	修改账号资料
绑定姓名	修改账号资料
怎么绑定姓名	修改账号资料
如何绑定姓名	修改账号资料
你好，我注册的时候名字少填了一个字	修改账号资料
如何绑定姓名	修改账号资料
姓名怎么绑定	修改账号资料
注册姓名填写	修改账号资料
绑定姓名	修改账号资料
注册邮箱跟手机号都忘了,也都没在使用	修改账号资料
我的手机或邮箱没在使用了	修改账号资料
注册电话或邮箱还在使用	修改账号资料
我的手机或邮箱没在使用了	修改账号资料
修改手机号	修改账号资料
我的号存款多少了	查询账号状态
我昨天累计存款多少？	查询账号状态
存款记录可以删除吗	查询账号状态
怎么删除存款记录?	查询账号状态
账户清单的资料可以删除吗	查询账号状态
账户清单的资料可以删除吗	查询账号状态
账户清单资料可以删除吗	查询账号状态
存款资料可以删掉吗	查询账号状态
账户清单资料可以删除吗	查询账号状态
那我问你要怎么删除我存款资料?	查询账号状态
查总存款和总提款	查询账号状态
存送百分之百送不了啊	首存咨询
首存有优惠吗	首存咨询
我申请存送100%怎么申请不起	首存咨询
我申请首存100%怎么申请不了	首存咨询
首存玩TP不是送%100吗	首存咨询
充一百送一百怎么申请	首存咨询
你好麻烦才一下我新注册的账号能不能百分百存送	首存咨询
百分百存送	首存咨询
请问一下我pt打了多少流水	刷新流水
帮我刷新一下投注	刷新流水
帮我刷新下流水	刷新流水
到底我还差多少流水啊？	刷新流水
更新流水	刷新流水
我还差多少流水呢？	刷新流水
更新一下流水我要户内转帐	刷新流水
刷新一下流水	刷新流水
更新一下流水我要户内转账	刷新流水
我PT游戏流水是不是错了麻烦查一下	刷新流水
我怎么打了几个小时流水都没有更新的	刷新流水
刷新一下pt投注流水	刷新流水
刷新一下投注流水	刷新流水
帮我更新一下pt流水	刷新流水
帮我pt自助洗吗刷新一下	刷新流水
刷新pt流水	刷新流水
帮我刷新一下PT转账流水	刷新流水
查一下我的投注	刷新流水
帮我刷新下pt平台流水，看下我能转账了不？	刷新流水
我现在流水多少	刷新流水
我流水够了为什么不能转账	刷新流水
我投注了多少流水了	刷新流水
你给我查查我的存送流水	刷新流水
我打了那么多我流水怎么没变每次都这样	刷新流水
刷新一下今天PT流水	刷新流水
帮我刷新下pt流水	刷新流水
往主账户转不了，帮我刷新一下	刷新流水
刷一下流水	刷新流水
流水刷新一下	刷新流水
刷一下流水，要转账	刷新流水
Pt往主账户转不了，帮我刷新一下	刷新流水
pt流水又不动了	刷新流水
pt流水给我刷新	刷新流水
PT流水刷一下	刷新流水
帮我更新一下PT流水，我要转账	刷新流水
帮我把PT户内转账刷新一下	刷新流水
给我刷新下PT流水	刷新流水
帮我把PT户内转账刷新一下	刷新流水
pt存送 流水怎多少了 一直更新不了	刷新流水
帮我把PT户内转账刷新一下	刷新流水
帮我pt流水刷新	刷新流水
麻烦把PT平台流水刷新一下，我要转账进去	刷新流水
帮我刷新下pt账号	刷新流水
直接帮我查我能领什么	咨询当下相关活动
那你看我现在还能领取什么礼金呢	咨询当下相关活动
今天有什么活动	咨询当下相关活动
我可以参加存送活动吗	咨询当下相关活动
我帐户可以领取什么彩金吗	咨询当下相关活动
给我查一下有什么可以领取的	咨询当下相关活动
申请签到彩金	咨询当下相关活动
签到彩金是怎样可以转出来	咨询当下相关活动
我的每日签到奖金怎么转到平台	咨询当下相关活动
我今天有什么优惠领取的	咨询当下相关活动
领签到彩金	咨询当下相关活动
给我查一下有什么可以领取	咨询当下相关活动
签到彩金10倍流水取款有没有上限	咨询当下相关活动
领取签到彩金	咨询当下相关活动
有没有任何彩金可以申请？	咨询当下相关活动
可以申请什么就帮我申请一下	咨询当下相关活动
给我查一下有什么可以领取的	咨询当下相关活动
我有什么优惠可以领取	咨询当下相关活动
我领签到彩金	咨询当下相关活动
给我查一下有什么可以领取的	咨询当下相关活动
申请签到彩金	咨询当下相关活动
帮我查一查可以申请什么优惠	咨询当下相关活动
我可以申请什么彩金了？	咨询当下相关活动
给我查一下有什么可以领取的	咨询当下相关活动
帮我领一下签到红包	咨询当下相关活动
申请一个免费彩金	咨询当下相关活动
存款有活动没啊	咨询当下相关活动
给我个优惠嘛	咨询当下相关活动
查看一下我有什么优惠可以领取	咨询当下相关活动
有什么优惠活动吗	咨询当下相关活动
推荐优惠	咨询当下相关活动
你们客服给我打电话我挺长时间没玩了说能给我彩金	咨询当下相关活动
帮我看看能申请什么优惠	咨询当下相关活动
姓名怎么绑定	自由对话
存款要什么手续费	存款相关问题
花呗可以用吗	存款相关问题
怎么存不起钱了呢	存款相关问题
怎不能存呢	存款相关问题
为啥不能存	存款相关问题
充的钱没有到账	存款相关问题
充钱怎么还没到?	存款相关问题
我钱咋还没到账	存款相关问题
怎么充钱	存款相关问题
刚充的钱  咋不上账	存款相关问题
钱咋不到账呢	存款相关问题
我冲钱没到	存款相关问题
可以用花呗上分吗？	存款相关问题
它说我活跃度不足，请选择其它通道	存款相关问题
不支持花呗交易吗	存款相关问题
支付宝转账没有到账	存款相关问题
我的充值没到	存款相关问题
微信可以扫码支付吗？	存款相关问题
怎么存款呢	存款相关问题
微信充值可以吗	存款相关问题
怎么存款还没到啊？	存款相关问题
我刚刚用支付宝转账存款200元，怎么还没有到帐啊？	存款相关问题
为什么我的充值还没有到账	存款相关问题
我的存款没到账	存款相关问题
微信快捷支付什么时候到账	存款相关问题
支付宝转账成功，怎么不到账？	存款相关问题
我的存款怎么还没到呢	存款相关问题
我用微信快捷支付充值100怎么没有到账	存款相关问题
存款咋个还没有到账	存款相关问题
支付宝转账存款没到账	存款相关问题
存款未到账	存款相关问题
游戏点卡充值怎么没有	存款相关问题
怎么充值还未到帐	存款相关问题
充值怎么充不了了	存款相关问题
我支付宝转账成功，怎么还没上分	存款相关问题
我存的钱这么还没有给我添加到主账户	存款相关问题
充值了半天怎么还没到账	存款相关问题
我用支付宝存款已成功，怎么还没有到我账户上呢？	存款相关问题
支付宝存款未到账	存款相关问题
怎么存款还没有的嘛	存款相关问题
用微信快捷付款成功，却没有到账	存款相关问题
网银转账没到账	存款相关问题
存款没到账	存款相关问题
为什么我的存款还没到账	存款相关问题
我的存款为什么还没到账	存款相关问题
我这都存上二十分钟了，啥时能到账啊	存款相关问题
在哪里充值	存款相关问题
你好，不会用久安钱包，复杂	存款相关问题
我二维码支付的钱几分钟了还没到帐	存款相关问题
帮忙看看我的存款怎么还没有到账呢	存款相关问题
我的存款没有到账	存款相关问题
存款没到账	存款相关问题
微信怎么不能存款呢	存款相关问题
存款什么时候到账	存款相关问题
我的存款还没到账啊，能你们查好了没有啊	存款相关问题
充值不了	存款相关问题
给我查下我刚刚的存款	存款相关问题
我充的钱还没到账	存款相关问题
我的充值怎么还没到	存款相关问题
怎么支付宝不能扫码支付啊？	存款相关问题
我刚存完的钱怎么账户里没有	存款相关问题
为什么我现在微信一直充不了钱	存款相关问题
支付宝花呗充值 充不进 商户有异常	存款相关问题
我支付宝转账成功了，账户没钱	存款相关问题
为什么我存了钱到现在还没到账？	存款相关问题
充钱怎么还不到？	存款相关问题
为什么存款一直在处理中	存款相关问题
花呗，可以用吗	存款相关问题
我刚刚存在了钱，为什么不到帐	存款相关问题
支付宝充值没到账	存款相关问题
银联转账怎么还没到这游戏账号	存款相关问题
久安钱包支付如何支付	存款相关问题
我存的钱怎么没到	存款相关问题
请帮我查一下，钱怎么这么久还没到账	存款相关问题
我刚刚用云闪付款120还没到账么	存款相关问题
还有什么方法可以充值	存款相关问题
我微信转账怎么用不了呢？	存款相关问题
点卡可以充值吗	存款相关问题
刚网上银行转账到现在还没有收到	存款相关问题
我存的钱，你们为啥还不给我到账	存款相关问题
现在还能用点卡充值吗	存款相关问题
存款怎么又没到	存款相关问题
我冲的钱怎么到不了帐啊？	存款相关问题
我银联扫码支付怎么还没到账	存款相关问题
我存的款半个小时了还没到啊	存款相关问题
我存款怎么半天没到	存款相关问题
充值可以用花呗	存款相关问题
我那个第三方还没到账呢	存款相关问题
支付宝转账能用吗	存款相关问题
我转的钱还没有到账	存款相关问题
微信快捷支付怎么还不到账？	存款相关问题
支付宝转账成功了但是账户里没有	存款相关问题
怎么充钱一直充不进	存款相关问题
我支付宝充了费为什么到现在还没到账呢？	存款相关问题
我刚才的存款怎么还没到账	存款相关问题
支付宝转账没有到账呢	存款相关问题
存款为什么不到账	存款相关问题
充值成功钱没到账	存款相关问题
存款到账，怎么还没有到账	存款相关问题
存款好几个小时了还没到	存款相关问题
我充钱怎么还不到账？	存款相关问题
刚才存的款还能到账么？	存款相关问题
帮我查下 我存款还没到账	存款相关问题
你们官网没点卡支付吗	存款相关问题
支付宝充值没到账	存款相关问题
久安钱包付不了咱回事	存款相关问题
存款怎么还没到账	存款相关问题
支付宝转账到账了 账户里咋还没到账啊	存款相关问题
我的存款怎么还没有到啊	存款相关问题
我支付宝转账怎么没到呀	存款相关问题
我微信存钱怎么操作呢？	存款相关问题
我的存款怎么还没有到啊	存款相关问题
为什么充值不了呢	存款相关问题
我的存款都过了一个多小时了还没到呢	存款相关问题
支付宝转账充值没有到	存款相关问题
转账成功怎么还没到账号	存款相关问题
我的存款没到呢	存款相关问题
银行扫码支付未到账	存款相关问题
转账成功怎么还没到游戏账户	存款相关问题
我的存款你帮我入账好了吗	存款相关问题
怎么还不到账支付宝存的	存款相关问题
刚刚我充直怎么没到	存款相关问题
我刚充了7000等了10分钟还没到账	存款相关问题
我昨天充了30.8元没到游戏。今天等了一天又没退我	存款相关问题
我充的钱怎么回事	存款相关问题
帮我看看充300到了木有	存款相关问题
怎么存不起钱了呢	存款相关问题
点卡充值可以不	存款相关问题
手机银行存款是半天不到账	存款相关问题
支持点卡嘛	存款相关问题
存款没到帐	存款相关问题
没办法存款	存款相关问题
不能存款	存款相关问题
取消订单	存款相关问题
银联支付	存款相关问题
支付宝转账	存款相关问题
支付宝扫码	存款相关问题
微信转账	存款相关问题
微信扫码	存款相关问题
在线支付	存款相关问题
支付宝充值没到账	存款相关问题
我刚充了7000 还没到账	存款相关问题
在线支付	存款相关问题
我用QQ冲了20没到账	存款相关问题
充值没到账	存款相关问题
存款没到	存款相关问题
微信扫码	存款相关问题
你好，为什么存款没有到	存款相关问题
我的存款人姓名是韩国	存款相关问题
存款未到账	存款相关问题
我充的钱怎么还没到	存款相关问题
我支付宝刚刚转老了100怎么还没到账	存款相关问题
手机银行支付半天不到	存款相关问题
如何使用久安存款	存款相关问题
支持什么银行	存款相关问题
我上次用点卡充的钱，现在还不给我到账	存款相关问题
咋整存款了为啥不到	存款相关问题
支付宝有笔存款，你给我看看怎么还没到账的	存款相关问题
微信存完钱了 没有显示	存款相关问题
存款没到	存款相关问题
久安钱包	存款相关问题
微信转账	存款相关问题
微信转账不能用阿	存款相关问题
微信扫码 没到	存款相关问题
取消我的微信订单	存款相关问题
存款到帐金额不对	存款相关问题
支付限额啦	存款相关问题
怎么在线支付不起	存款相关问题
我的存款我怎么没有到账啊？	存款相关问题
日死你妈批游戏随时都充值不到账	存款相关问题
我从其他平台来的，给个试玩吧	游戏咨询
我刚刚的球赛注单哪看	游戏咨询
我玩冰球突破怎么中奖了没给我分	游戏咨询
中奖了给的钱不对	游戏咨询
游戏太吃分了吧	游戏咨询
给个试玩吧	游戏咨询
PT电子登录加上什么	游戏咨询
pt登录器加什么	游戏咨询
pt客户端怎么登陆	游戏咨询
pt客户端登录加什么	游戏咨询
PT客户端登录前面加什么大写字母？	游戏咨询
捕鱼客户端前加什么字母么	游戏咨询
pt客户端加什么首字母	游戏咨询
请问pt平台登入时前面加什么字母	游戏咨询
ptAPP登录前面加什么	游戏咨询
pt手机客户端前面要加什么嘛	游戏咨询
pt客户端登陆前要加什么吗？	游戏咨询
电脑登录客户端需要加什么	游戏咨询
pt手机登录加什么	游戏咨询
PT的app前面交什么字母	游戏咨询
pt客服端登录加什么	游戏咨询
你们网页版怎么没有三倍猴子这个游戏	游戏咨询
PT客户端登录前边加啥	游戏咨询
PT客户端登录账号前面加什么	游戏咨询
客户端首字母是多少	游戏咨询
PT登录在什么前缀	游戏咨询
请问PT客户端怎么登陆	游戏咨询
app登录，前面加什么？	游戏咨询
手机PT客服端前面加什么字母	游戏咨询
pt客户端前边家啥？	游戏咨询
PT客户端登录需要加后缀吗？	游戏咨询
pt登录前面加什么	游戏咨询
pt客户端登陆时前面加什么	游戏咨询
PT客户端前面需要＋什么符号吗？	游戏咨询
PT客户端帐号前加什么字母	游戏咨询
今天pt 什么游戏比较出分的	游戏咨询
PT客户端帐号前加什么字	游戏咨询
这个投注记录如何查看了	游戏咨询
手机pt客户端登陆，账号前加什么吗	游戏咨询
SW DT出分的游戏	游戏咨询
目前DT哪几个游戏出分高	游戏咨询
pt现在那个出分	游戏咨询
pt现在哪个出分啊	游戏咨询
Pt游戏什么出分	游戏咨询
pt现在哪个游戏出分	游戏咨询
请问这会有没有什么好打的mg游戏呢	游戏咨询
麻烦您帮我看看出分游戏谢谢	游戏咨询
PT客户端  首字母加什么	游戏咨询
pt玩那个游戏能赢钱？	游戏咨询
麻烦您帮我看看出分游戏谢谢	游戏咨询
登录手机客户端前面需要添加什么	游戏咨询
mwg捕鱼客户端登陆前缀是什么	游戏咨询
请问登录PT客户端时账号前无要输什么字母？	游戏咨询
pt客户端前边家啥？	游戏咨询
DT,PT出分高的游戏给我找一下	游戏咨询
pt客服端前缀是什么	游戏咨询
美女，这会pT，DT什么好打呢？	游戏咨询
美女，这会pT，DT什么好打呢？	游戏咨询
出分游戏	游戏咨询
出分游戏	游戏咨询
出分游戏	游戏咨询
几百手不爆分 什么情况	游戏咨询
今天什么游戏出分?	游戏咨询
打什么游戏出分?	游戏咨询
出分游戏	游戏咨询
哪个游戏出分	游戏咨询
出分游戏有哪些	游戏咨询
出分游戏推荐一下	游戏咨询
登录pt客户端前面加什么？	游戏咨询
我电脑玩卡，还换手机玩，免费游戏就没有了	游戏进不去
pt为啥登不上	游戏进不去
所有网址都无法进入沙巴体育	游戏进不去
为什么网页版的玩不成	游戏进不去
为什么pt游戏不能玩	游戏进不去
我pt游戏为什么进不去	游戏进不去
为什么不能游戏？	游戏进不去
什么游戏都不能玩	游戏进不去
你好突破冰球我进不去了	游戏进不去
pt玩不了	游戏进不去
怎么ag进不去啊	游戏进不去
你们网站什么意思 我打到打到游戏就说我登录失败	游戏进不去
为什么pt玩不了	游戏进不去
PT游戏为啥玩不了	游戏进不去
pt游戏还是玩不了	游戏进不去
进app然后游戏进不去	游戏进不去
帮我粉碎pt场里手机端没完成的游戏	游戏进不去
这DT又进不去了	游戏进不去
怎么显示无法起动游戏	游戏进不去
我免费游戏到那去了	游戏进不去
免费游戏中卡死了	游戏进不去
pt为啥登不上	游戏进不去
我电脑玩卡，还换手机玩，免费游戏就没有了	游戏进不去
错误编码3	游戏进不去
bbin网络掉线余额没恢复	游戏进不去
MG冰球突破玩不了	游戏进不去
查一下密码	忘记密码
重新设置密码	忘记密码
没有在邮箱里收到登录密码啊	忘记密码
这号玩不了了，密码不知道多少	忘记密码
忘记密码	忘记密码
密码重置	忘记密码
密码忘了	忘记密码
帮我找回密码	忘记密码
登入显示多次输入错误  要重置密码	忘记密码
我的登陆密码忘了，可以帮我找回吗	忘记密码
我登陆密码忘记了	忘记密码
麻烦查查登录密码并解冻	忘记密码
请告诉我登陆密码	忘记密码
我好久没玩了，密码忘记了	忘记密码
我忘记密码了	忘记密码
麻烦帮忙下密码找不回来啦	忘记密码
密码怎么找回	忘记密码
他说我密码错了多次。把他锁定了	忘记密码
我的密码忘记了	忘记密码
忘记了密码了怎么办？	忘记密码
我忘记密码了啊	忘记密码
登陆密码忘了	忘记密码
忘记密码被冻结了	忘记密码
我的登录密码不记得	忘记密码
我之前注册的手机号码已经不用了，现在密码要重置怎么办	忘记密码
我忘了密码了	忘记密码
忘记登录密码了	忘记密码
我密码忘了	忘记密码
忘记密码了	忘记密码
忘记密码了	忘记密码
可以改密码吗	忘记密码
密码错误	忘记密码
我要修改密码	忘记密码
我要修改密码	忘记密码
我的游戏密码忘记了	忘记密码
我需要修改密码	忘记密码
我能登录，只是想要换密码	忘记密码
我能登录，只是想要换密码	忘记密码
账号被锁定了，忘记密码了	忘记密码
我申请红包	红包咨询
红包优惠卷在哪里兑换啊？	红包咨询
红包优惠券给我	红包咨询
可以申请免费红包来玩玩吗一直都是输	红包咨询
想领个红包了	红包咨询
申请存送优惠券	红包咨询
特邀怎么回事	红包咨询
红包优惠券在哪申请啊	红包咨询
帮忙查下我的红包优惠卷什么问题	红包咨询
谁能送我红包优惠券	红包咨询
麻烦看下有没有彩金红包可以申请	红包咨询
红包转到pt，他说我优惠码出现错误	红包咨询
你们娱乐城有转运金申请吗？	红包咨询
我的红包代码怎么不能用	红包咨询
给我申请个转运红包呗大点的红包	红包咨询
申请一个红包	红包咨询
给我发了一个优惠卷为什么我不能用？	红包咨询
申请转运红包	红包咨询
帮我申请一个转运红包	红包咨询
存送优惠券怎么不能领	红包咨询
红包优惠卷是什么意思	红包咨询
红包优惠券怎么才能领取？	红包咨询
申请个红包玩	红包咨询
红包优惠劵是什么？	红包咨询
你看我帐号能发什么红包嘛	红包咨询
申请转运红包	红包咨询
申请红包	红包咨询
我收到两个短信.说加微信领取专属红包	红包咨询
能不能申请个红包	红包咨询
使用优惠券之后额度不见了	红包咨询
红包优惠卷怎么用	红包咨询
红包怎么用	红包咨询
给我弄个转运红包	红包咨询
帐号，和密码忘了	账号解锁、忘记账号
我账号密码忘了，只知道银行卡号	账号解锁、忘记账号
看看我的登录号多少？	账号解锁、忘记账号
为什么我被禁用？	账号解锁、忘记账号
忘记帐号和密码	账号解锁、忘记账号
我的游戏账号里面的pt平台，怎么还锁上了？	账号解锁、忘记账号
找回账号	账号解锁、忘记账号
账号被锁了	账号解锁、忘记账号
我账号被禁用了是几个意思？	账号解锁、忘记账号
忘记会员账号	账号解锁、忘记账号
账号忘记了	账号解锁、忘记账号
我忘记我账号了	账号解锁、忘记账号
我忘记我的账号了	账号解锁、忘记账号
我忘记账号了	账号解锁、忘记账号
帮忙查下帐号	账号解锁、忘记账号
忘记账号密码	账号解锁、忘记账号
帮我找下账户	账号解锁、忘记账号
忘记账号了	账号解锁、忘记账号
帐号密码忘记了	账号解锁、忘记账号
登录密码和帐号忘记了	账号解锁、忘记账号
我的账号密码忘了	账号解锁、忘记账号
我忘记我的账号跟密码了	账号解锁、忘记账号
我忘记了我的账号密码	账号解锁、忘记账号
账号锁定了	账号解锁、忘记账号
我忘记了我的账号和密码	账号解锁、忘记账号
我要找回我的账号	账号解锁、忘记账号
你好，我把我账号密码忘了，怎么办	账号解锁、忘记账号
我想找回我的账号	账号解锁、忘记账号
我手机号，和邮箱知道，账号密码忘了怎么办	账号解锁、忘记账号
我的账号被你们冻结了	账号解锁、忘记账号
忘记账号和密码	账号解锁、忘记账号
麻烦你帮我找一下，我的一个帐号差不多有半年多没有玩了	账号解锁、忘记账号
解锁账户	账号解锁、忘记账号
我电话注册的账号是多少	账号解锁、忘记账号
忘了帐号了	账号解锁、忘记账号
帐号忘了	账号解锁、忘记账号
为什么我的账号被锁了	账号解锁、忘记账号
我的账号咋禁用了	账号解锁、忘记账号
麻烦你帮我账号解锁	账号解锁、忘记账号
请问我不记得账号了可以找回来吗	账号解锁、忘记账号
亲我的账号和密码忘记了	账号解锁、忘记账号
解冻账号	账号解锁、忘记账号
忘记账号和密码	账号解锁、忘记账号
我刚申请的账号然后忘了	账号解锁、忘记账号
那麻烦你现帮我解下锁	账号解锁、忘记账号
我的账号跟密码都忘了怎么办	账号解锁、忘记账号
麻烦帮我找下账号	账号解锁、忘记账号
登录账号名忘了怎么办？	账号解锁、忘记账号
账号忘了	账号解锁、忘记账号
账号解锁	账号解锁、忘记账号
账号解冻	账号解锁、忘记账号
我的账号忘记了呢	账号解锁、忘记账号
账户和密码忘了怎么办？	账号解锁、忘记账号
账号忘记了怎么办	账号解锁、忘记账号
忘记账号和密码	账号解锁、忘记账号
帐号被锁了	账号解锁、忘记账号
麻烦帮我查询下我的账号	账号解锁、忘记账号
我把账号忘了	账号解锁、忘记账号
我忘记了我的账号怎么办	账号解锁、忘记账号
为什么把我的号冻结？	账号解锁、忘记账号
忘记账号了	账号解锁、忘记账号
忘记帐号怎么办	账号解锁、忘记账号
我的账号密码忘了	账号解锁、忘记账号
能帮我找回账号吗	账号解锁、忘记账号
请帮我找回账号一下嘛	账号解锁、忘记账号
忘记密码了	账号解锁、忘记账号
通过注册电话能找回账号吗	账号解锁、忘记账号
不记得用户名了	账号解锁、忘记账号
账户冻结是什么意思？	账号解锁、忘记账号
帐号锁了	账号解锁、忘记账号
帐号锁了	账号解锁、忘记账号
忘记帐号了	账号解锁、忘记账号
忘记帐号	账号解锁、忘记账号
我的账号登不进去	账号解锁、忘记账号
账号不能登录	账号解锁、忘记账号
我忘记账号了	账号解锁、忘记账号
账号密码忘了怎么办	账号解锁、忘记账号
账号密码都忘了怎么办	账号解锁、忘记账号
我昨晚注册了一个号，但我现在把账号和密码都忘了应该怎么找回来啊	账号解锁、忘记账号
我的账号忘记了	账号解锁、忘记账号
那我账号忘了	账号解锁、忘记账号
忘记登录名	账号解锁、忘记账号
账号密码记不得了	账号解锁、忘记账号
忘记账号和密码了	账号解锁、忘记账号
为什么我中心钱包的钱转不出来	转账咨询
钱在老虎机包里可以玩什么游戏	转账咨询
我申请的体验金在老虎机钱包里面，这个钱包对应的是哪个电子游戏平台啊	转账咨询
怎么我不能户内转账呢？	转账咨询
请问下体验金我领取到老虎机账户里面了，我可以转到PT老虎机里面去玩吗	转账咨询
额度转换不了，提示系统繁忙	转账咨询
刚才转进pt没转进去	转账咨询
怎么转账到BBIN不行哦	转账咨询
BBIN怎么不能转账啊	转账咨询
怎么PT无法转账回主账户啊，转账就是系统繁忙啊	转账咨询
户内转账系统繁忙？	转账咨询
我回收主账户怎么回收不了	转账咨询
我主账户钱转老虎机里转不了	转账咨询
我转账到pt平台，可转不过去	转账咨询
怎么转账到游戏中	转账咨询
主账户余额不足	转账咨询
怎么转账到游戏中	转账咨询
主账户余额不足	转账咨询
钱咋存不到DT呢	转账咨询
户内转帐没到	转账咨询
不能户内转帐	转账咨询
户内转账转不出来	转账咨询
不能进行或户内转账	转账咨询
转账失败	转账咨询
