PT客户端连接	app咨询
我需要pt客户端	app咨询
我怎么PT客户端下载不了啊	app咨询
app为什么下不了？	app咨询
PT游戏下载不了怎么办	app咨询
pt客户端 现在下载链接不好使啊 你给我个下载地址我试试	app咨询
pt怎么不能下载呢	app咨询
下载app	app咨询
app在哪儿下哦	app咨询
app在哪下载	app咨询
PT客户端不好下载	app咨询
下载不了PT游戏	app咨询
怎么下载app	app咨询
下不了app啊	app咨询
为什么app 不可以使用了	app咨询
客户端下载	app咨询
下载不了PT客户端	app咨询
发个手机app下载	app咨询
app下载网址多少	app咨询
app下载以后点进去就闪退，删了几次都是这样	app咨询
怎么下载app	app咨询
怎么下载手机app	app咨询
怎么下载电脑客户端	app咨询
哪里下载app	app咨询
苹果的手机app怎么安装	app咨询
怎么下不了app	app咨询
你好给我个网址下载app	app咨询
app怎么下不了	app咨询
如何升级VIP	VIP咨询
有没生日彩金	VIP咨询
还能申请生日红包吗	VIP咨询
帮我把vip每月免费筹码开启派发一下	VIP咨询
把晋级礼金发给我吧！	VIP咨询
生日礼金，领了怎么没有	VIP咨询
那个我领了生日彩金，怎么没有看见啊！	VIP咨询
申请生日红包	VIP咨询
为何不能领取VIP筹码？	VIP咨询
你好问一下我的生日礼金怎么领取	VIP咨询
生日礼金怎么无法领取	VIP咨询
领取一下生日彩金	VIP咨询
我的生日礼金如何领取？	VIP咨询
申请生日礼金	VIP咨询
我的免费筹码领不出来	VIP咨询
免费筹码我怎么不能领	VIP咨询
请问vip免费筹码在哪领取？	VIP咨询
我申请生日礼金	VIP咨询
领取免费筹码	VIP咨询
生日礼金什么时候领取	VIP咨询
怎么我这个月没有vip免费彩金呢	VIP咨询
申请生日礼怎么申请	VIP咨询
我都等了三十多分钟了	抱怨
已经过了半个多小时了	抱怨
请问怎么注销账号	抱怨
是不是骗人的平台	抱怨
狗娘养的 太会吃分了	抱怨
你妈的批，钱存不起，游戏又死，打你妈的批	抱怨
你这骗人平台	抱怨
你们这骗人平台	抱怨
你们平台骗人	抱怨
你们这群骗子	抱怨
骗人没有好下场	抱怨
你们不会是骗人的吧	抱怨
你们骗人的吧	抱怨
现在申请不了、岂不是骗人的！	抱怨
你骗人上瘾了吗	抱怨
你们平台骗人是吧	抱怨
啥游戏平台，简直骗钱	抱怨
遇到你们平台骗人	抱怨
你们这活动是骗人的？	抱怨
我以为你们不会是骗人的网站！但现在看来也是吗	抱怨
真没意思的！全是骗人的！	抱怨
全是骗人的！	抱怨
你们都是骗人的吧	抱怨
把这样的游戏拿出来骗人	抱怨
怎么骗人呢	抱怨
尽说些畜生都不如的话来骗人	抱怨
你们这帮骗子	抱怨
妈的骗人这么像	抱怨
搞个假网站骗人钱财	抱怨
骗也死人的	抱怨
说发个转运红包还骗人	抱怨
申请不了，骗人的吗	抱怨
等24小时的都是她妈骗人的	抱怨
你们骗人的吧    app根本下载不了	抱怨
还要等多久嘛	抱怨
等多久啊	抱怨
还要等多久嘛	抱怨
是要等多久	抱怨
要等多久	抱怨
还要多久	抱怨
等多久嘛	抱怨
要等多久呢	抱怨
是要我等多久	抱怨
你就跟我说要多久	抱怨
我从昨天等到现在，到底要等多久	抱怨
昨天就说让我等，等到今天还让我等了	抱怨
还让我等多久了	抱怨
需要等多久能到账啊？	抱怨
那得等多久啊？	抱怨
到底要等多久呢？	抱怨
那么简单的事，还要等多久	抱怨
要等多久嘛	抱怨
那是要好久？	抱怨
我问你 好久给我处理 你不要给我说那些没有用的废话	抱怨
还有好久	抱怨
好久了，还不好	抱怨
到底要好久？	抱怨
我这个要多久	抱怨
还要好久嘛？	抱怨
很久了耶	抱怨
还等很久了？	抱怨
要好久	抱怨
还要好久	抱怨
要那么久？	抱怨
也太久了吧	抱怨
网站发来	不能登录
怎么无法登录	不能登录
把官网网址发过来	不能登录
官网网址	不能登录
网站多少Ip	不能登录
网站多少Ip	不能登录
手机版网址是多少	不能登录
你网站好卡阿	不能登录
网站卡成这样	不能登录
网站这样卡	不能登录
网站超卡	不能登录
网站好卡	不能登录
网站卡卡的	不能登录
你们网站好卡	不能登录
官网网址多少 电脑版	不能登录
网址	不能登录
网址是多少	不能登录
官网是多少	不能登录
最新网址	不能登录
你们的网站地址	不能登录
麻烦给我发一个你们最官方最新的网站	不能登录
我怎么登录不了	不能登录
怎么我登PT客户端登不上？	不能登录
怎么网站打不开啊	不能登录
跳转到其它网站去	不能登录
我还是登不上去pt，又冻结了	不能登录
登陆pt游戏的时候总显示帐号密码不正确	不能登录
我登录app怎么登不上	不能登录
手机网页版网址是什么	不能登录
密保问题忘记怎么办	密保银行卡解绑
解除银行卡，从新绑定	密保银行卡解绑
我的卡号多少	密保银行卡解绑
帮我查下卡号	密保银行卡解绑
我的银行卡号多少	密保银行卡解绑
看一下我的卡号	密保银行卡解绑
自助反水怎么显示上一笔反水未审核	返水咨询
我的洗马怎么没钱啊	返水咨询
我自助洗码怎么是0	返水咨询
你好我这洗马怎么没有投注记录	返水咨询
你好我这洗码怎么没有投注记录	返水咨询
你好我这反水怎么没有投注记录	返水咨询
你好我这返水怎么没有投注记录	返水咨询
自助反水什么时候才有	返水咨询
我的反水怎么不行啊	返水咨询
怎么不能领反水	返水咨询
反水又在审核	返水咨询
我的反水怎么还在显示上一笔反水还在审核	返水咨询
我怎么刚才没领到反水	返水咨询
我自助反水怎么没有更新呀？	返水咨询
怎么一直显示上一笔洗码自助审核中	返水咨询
我看不到我自助反水	返水咨询
反水几点派发	返水咨询
帮我刷新一下PT自助反水	返水咨询
PT厅投注没有反水吗	返水咨询
pt怎么洗码没有	返水咨询
我的MG为什么没有反水	返水咨询
反水刷新过来	返水咨询
说我上一笔秒提未审核	提款相关问题
取消我的提款	提款相关问题
把我的提款退回来	提款相关问题
我刚才提款了，怎么一直没有到	提款相关问题
提现要审核几长时间	提款相关问题
我提款怎么老在审核	提款相关问题
你好，我提款怎么提不了	提款相关问题
提款怎么这么慢哦	提款相关问题
为什么我的提款申请一直被拒绝	提款相关问题
你好 我的提款没有处理吗	提款相关问题
为什么提款取消	提款相关问题
我提款100怎么还不给我审核到账啊	提款相关问题
请问我的提款怎么一直在审核？？	提款相关问题
提款这次要等多久	提款相关问题
怎么提款还没到呀	提款相关问题
我的取款怎么还没到账	提款相关问题
为什么提款又退回来了	提款相关问题
我的钱出了吗	提款相关问题
帮我出款了吗	提款相关问题
我的款什么时候能出	提款相关问题
什么时候出款	提款相关问题
出款了吗？	提款相关问题
帮我出款	提款相关问题
我要取消提款	提款相关问题
帮我取消提款	提款相关问题
取消提款	提款相关问题
给我取消提款	提款相关问题
退回我的提款	提款相关问题
把我的提款退了吧	提款相关问题
取消出款	提款相关问题
我的出款取消了吧	提款相关问题
把我的出款取消	提款相关问题
提款又退回来了什么情况	提款相关问题
提款审核中 不提款了 直接返回账户里	提款相关问题
我出款怎么取消了?	提款相关问题
我的提款怎么老是待审核？	提款相关问题
你们家提款有什么限制吗	提款相关问题
我刚刚出的钱还没到	提款相关问题
取款没有到	提款相关问题
重置取款密码	提款相关问题
帮我催下提款呢	提款相关问题
提款还没审核吗	提款相关问题
说支付密码错误怎么办	提款相关问题
提现要审核多久	提款相关问题
提现一直待审核	提款相关问题
提款要多久的呢？	提款相关问题
提款怎么这么久？	提款相关问题
为什么我提不了现	提款相关问题
提款待审核	提款相关问题
我提款需要多久	提款相关问题
提款的一般多久到账	提款相关问题
提款多久到？	提款相关问题
为什么提款没到账	提款相关问题
取款密码忘了	提款相关问题
提款怎么那么慢呢？	提款相关问题
提款半天了 也不显示审核怎么回事	提款相关问题
提款要审核很久吗	提款相关问题
帮我看看我的提款	提款相关问题
提款要多久到	提款相关问题
为什么提款就取消	提款相关问题
为什么提现提不出来	提款相关问题
我那钱怎么取不了呢	提款相关问题
我的提款什么时候能到我的银行卡里	提款相关问题
刚刚提款，还没到账？	提款相关问题
注册送多少彩金	体验金咨询
这个不是有开户送吗	体验金咨询
体验金在哪领	体验金咨询
体验金怎么用	体验金咨询
注册送彩金？	体验金咨询
我邮箱收到信息，说注册可以领取68元彩金，真的假	体验金咨询
体验金在哪领	体验金咨询
注册彩金 我咋没看到啊	体验金咨询
我收到短信说注册送88	体验金咨询
是否注册送68	体验金咨询
刚注册的会员，是不是要送88？	体验金咨询
我注册了领送的彩金怎么领不了	体验金咨询
激活送58什么意思	体验金咨询
自助体验金是什么	体验金咨询
注册送菜金吗	体验金咨询
注册送彩金吗	体验金咨询
注册送白菜吗	体验金咨询
你好，现在注册送彩金吗？	体验金咨询
注册彩金有什么限制	体验金咨询
开户体验金	体验金咨询
收到短信领取彩金66	体验金咨询
体验金可以玩古怪猴子吗	体验金咨询
体验金怎么领取	体验金咨询
我QQ收到短信注册送88彩金是真的吗	体验金咨询
开户送彩金吗？	体验金咨询
申请开户彩金	体验金咨询
申请注册送83	体验金咨询
开户68怎么领取？	体验金咨询
体验金多少能提款	体验金咨询
体验金多少钱提款	体验金咨询
体验金打多少可以提款	体验金咨询
体验金要打多少流水	体验金咨询
体验金打多少提款	体验金咨询
注册送菜金是真的吗	体验金咨询
送我88菜金	体验金咨询
注册送菜金	体验金咨询
有体验的菜金吗	体验金咨询
请问注册得68在哪里申请啊	体验金咨询
注册送彩金在哪了	体验金咨询
注册赠送体验金吗？	体验金咨询
刚才看邮箱收到邮件说是注册送彩金？？	体验金咨询
收到信息说注册送68	体验金咨询
注册新会员送免费彩金吗？	体验金咨询
申请88元彩金	体验金咨询
注册送彩金怎么没有	体验金咨询
新开户是送88元幸运彩金吗	体验金咨询
邮箱收到注册送88	体验金咨询
你好，我申请体验金，手机验证不了怎么办	体验金咨询
你好申请开户彩金	体验金咨询
自助体验金怎样申请啊？	体验金咨询
注册送多少	体验金咨询
注册送钱吗	体验金咨询
注册送	体验金咨询
注册送体验金	体验金咨询
注测有送吗	体验金咨询
为什么我领取我的优惠活动，手机验证码收不到？	体验金咨询
注册有彩金没有	体验金咨询
注册彩金还要申请吗	体验金咨询
接受不到短信验证码	体验金咨询
收不到验证码	体验金咨询
收不到手机简讯验证码	体验金咨询
没收到验证码	体验金咨询
显示没收到验证码	体验金咨询
收到验证码了吗	体验金咨询
下载app送88？	app咨询
不是注册送彩金吗？	体验金咨询
注册送49?	体验金咨询
收到邮件，说注册送88彩金	体验金咨询
我的app下载彩金从注册到现在都没有？	app咨询
为什么我领取不了app彩金？	app咨询
我没办法领取彩金，一直显示的是注册讯息重复	体验金咨询
怎么领取注册彩金	体验金咨询
注册送彩金，怎么申请	体验金咨询
收到短信，领取58彩金	体验金咨询
体验金只能在哪里玩	体验金咨询
为什么我申请不了注册体验金？	体验金咨询
我收到邮件说注册送28是不是真的	体验金咨询
注册送彩金28-88	体验金咨询
那个开户送礼金怎么送	体验金咨询
注册送118哦	体验金咨询
收到邮箱信息，注册送彩金28-88元，请问是真的吗	体验金咨询
体验金多少流水可以取款？最低取款多少	体验金咨询
不是说注册要送彩金吗	体验金咨询
发邮件给我说注册送28——88	体验金咨询
你们发信息到我手机上说只要注册就送78	体验金咨询
开户礼金可以玩MG游戏吗？	体验金咨询
新用户彩金在哪里领取	体验金咨询
注册送彩金吗？	体验金咨询
收到邮件注册送28-88	体验金咨询
我是第一次注册金怎么会说信息重复	体验金咨询
你们不是注册就送体验金吗	体验金咨询
接到邮件，注册送78	体验金咨询
申请68彩金，我是收到邮箱来的	体验金咨询
不是说注册就送吗	体验金咨询
不是说注册送吗？	体验金咨询
注册彩金说我信息重复？	体验金咨询
领取注册彩金	体验金咨询
帮我领取一下下载app彩金	app咨询
申请68彩金	体验金咨询
有注册彩金吗	体验金咨询
收到邮件注册送28怎么领取	体验金咨询
收到短信，注册送88元	体验金咨询
代理账号忘	官网及账号问题
代理其他佣金提款了，什么时候可以到账啊	官网及账号问题
为什么总是注册不成功	官网及账号问题
我代理你们平台	官网及账号问题
代理佣金提现一般多久到账	官网及账号问题
你们代理的佣金怎么提不出来	官网及账号问题
代理专员周一至周六几点上下班	官网及账号问题
代理的提款	官网及账号问题
怎么清缓存阿	官网及账号问题
怎么清除缓存	官网及账号问题
缓存怎么清	官网及账号问题
缓存怎么清除	官网及账号问题
我的专属客服呢	官网及账号问题
我的专属客服是谁	官网及账号问题
谁是专属客服	官网及账号问题
专属客服	官网及账号问题
我的微信客服	官网及账号问题
我的客服微信号	官网及账号问题
给我专属客服微信号	官网及账号问题
专属客服都不回话	官网及账号问题
专属客服上班了吗	官网及账号问题
专属客服黑名单我	官网及账号问题
专属客服黑单我	官网及账号问题
专属客服不回话	官网及账号问题
专属客服不理我	官网及账号问题
更换专属客服	官网及账号问题
专属客服微信号	官网及账号问题
专属客服QQ号	官网及账号问题
专属客服有QQ吗	官网及账号问题
专属客服有扣扣吗	官网及账号问题
专属客服的扣扣	官网及账号问题
给我专属客服的扣扣	官网及账号问题
怎么清除缓存	官网及账号问题
如何清除缓存	官网及账号问题
清缓存	官网及账号问题
怎么清缓存	官网及账号问题
教我清缓存	官网及账号问题
不会清缓存	官网及账号问题
我不会清缓存	官网及账号问题
不会清除缓存	官网及账号问题
邮箱是什么格式	官网及账号问题
我注册账号为什么手机被已被使用了？	官网及账号问题
我注册账号提示我的手机号有注册过是怎么回事啊	官网及账号问题
我是第一次注册怎么说我注册过	官网及账号问题
代理有没有生日礼金	官网及账号问题
这两天我的救援金怎么没法呢？？	救援金咨询
为什么没有救援金了	救援金咨询
救援金不是自己领取吗	救援金咨询
几点发救援金	救援金咨询
我没有救助金吗	救援金咨询
救援金是白天发放的啊？	救援金咨询
我领取了救援金，为什么账号上没有	救援金咨询
救援金好久到	救援金咨询
把救援金给我派发了吧	救援金咨询
负盈利反水要几倍流水的	救援金咨询
救援金现在都几点派发	救援金咨询
申请救援彩金	救援金咨询
我的救援金怎么没有到账号上呀？	救援金咨询
现在系统是在更新吗？	系统维护状况说明
这个时间是 提现维护么	系统维护状况说明
微信转账还没有维护好吗	系统维护状况说明
提款维护到什么时候	系统维护状况说明
提款维护到几点	系统维护状况说明
ebet要维护多久	系统维护状况说明
DT维护到什么时候	系统维护状况说明
账号很久没用了，以前手机绑定可以更换吗	修改账号资料
手机停机了，号码能不能换	修改账号资料
你好，可以修改电话号码吗？？	修改账号资料
邮箱可以更换吗	修改账号资料
可以帮我看一下手机号多少吗	修改账号资料
可以帮我看一下邮箱多少吗	修改账号资料
可以帮我看一下银行卡号多少吗	修改账号资料
我的手机号多少	修改账号资料
我的邮箱号多少	修改账号资料
帮我查手机号	修改账号资料
帮我查邮箱	修改账号资料
看一下我的手机号	修改账号资料
看一下我的邮箱	修改账号资料
看一下我的邮箱号	修改账号资料
帮我查下邮箱号	修改账号资料
我的手机号换了，这上面怎么换啊	修改账号资料
怎么修改手机号	修改账号资料
请问我以前的电话号码没用了，怎么修改新的号码	修改账号资料
请问我想修改手机怎么操作	修改账号资料
修改手机号码	修改账号资料
手机号没用了可以更改吗	修改账号资料
就是名字打错了	修改账号资料
绑定的手机号不可以改的吗	修改账号资料
我可以跟换绑定的手机号码吗？	修改账号资料
可以修改手机号吗	修改账号资料
可以修改邮箱号吗	修改账号资料
帮我查下充了多少钱？	查询账号状态
我怎么所有的出款记录都看不到了	查询账号状态
我所有的存款记录	查询账号状态
我所有的提款记录	查询账号状态
出款记录	查询账号状态
存款记录	查询账号状态
从以前到现在的存款金额	查询账号状态
总共存多少	查询账号状态
总共提多少	查询账号状态
从以前到现在的提款金额	查询账号状态
帮我查下总存款	查询账号状态
帮我查下总提款	查询账号状态
我怎么没有充值记录	查询账号状态
帮我查询一下我的总存款额	查询账号状态
帮我查下今日存款和提款	查询账号状态
新用户首存赠送怎么申请	首存咨询
首存也可以玩古怪猴子吗	首存咨询
首存多少能提款	首存咨询
首存多少钱提款	首存咨询
首存打多少可以提款	首存咨询
首存要打多少流水	首存咨询
首存打多少提款	首存咨询
首存打多少流水	首存咨询
首存打多少流水提款	首存咨询
首存多少流水	首存咨询
首存几倍水提款	首存咨询
我今天刚刚注册的账号怎么不能申请首存百分百啊	首存咨询
百分百存送	首存咨询
昨天申请号存了100没有给首存优惠	首存咨询
存10元送10元是什么	首存咨询
有首存优惠吗	首存咨询
那个首存百分百的活动	首存咨询
帮我把游戏刷新一下 现在看不到流水	刷新流水
流水刷了很久一直转账不了	刷新流水
帮我刷新一下pt投注额	刷新流水
怎么流水没有显示	刷新流水
你好流水怎么打不完呢？	刷新流水
更新下pt流水	刷新流水
流水限制解除一下	刷新流水
帮我刷新一下pt流水，我转到主账户转不了	刷新流水
帮忙刷新下老虎机流水	刷新流水
请帮我更新流水	刷新流水
帮我刷新一下	刷新流水
麻烦帮我刷新一下投注流水	刷新流水
帮我刷新下pt流水 我转账	刷新流水
刷新一下老虎机账号流水	刷新流水
帮忙刷新下流水	刷新流水
请帮我刷新一下PT流水	刷新流水
我说我要户内转账，给我把pt平台数据刷新	刷新流水
我流水怎么还不更新啊？	刷新流水
麻烦再给我刷新下pt数据	刷新流水
流水卡住了	刷新流水
PT流水卡住	刷新流水
帮我把PT流水刷新一下吧，我要转账的。	刷新流水
刷新PT投注额	刷新流水
给我刷新pt申请优惠以后得总投注	刷新流水
更新一下p t平台的自助流水	刷新流水
帮我刷新投注额我要转账	刷新流水
把我pt流水刷新下	刷新流水
帮我把MG流水刷新一下	刷新流水
帮我刷下流水我要转账	刷新流水
查询能不能提款流水够不够	刷新流水
我存送的流水够没有	刷新流水
麻烦帮忙查一下流水	刷新流水
帮我查下我流水够没我好提款	刷新流水
pt户内转账，刷新下流水	刷新流水
帮我刷新一下流水	刷新流水
更新pt流水	刷新流水
帮忙查查还需要多少流水能户内转账	刷新流水
更新一下流水	刷新流水
帮我查一下 ， 我的流水应该够了吧 ？	刷新流水
次存多少能提款	次存咨询
次存多少钱提款	次存咨询
次存打多少可以提款	次存咨询
次存要打多少流水	次存咨询
次存打多少提款	次存咨询
次存打多少流水	次存咨询
次存打多少流水提款	次存咨询
次存多少流水	次存咨询
次存几倍水提款	次存咨询
次次存每天只能优惠一次吗	次存咨询
签到去哪签	咨询当下相关活动
查查我可以领什么优惠	咨询当下相关活动
我可以领什么	咨询当下相关活动
我可以参加什么活动	咨询当下相关活动
我可以参加什么优惠	咨询当下相关活动
我有什么优惠吗	咨询当下相关活动
查查我可以领什么优惠	咨询当下相关活动
存款有优惠吗	咨询当下相关活动
我签到里的钱   怎么不能转账	咨询当下相关活动
可以找你们申请优惠吗	咨询当下相关活动
想玩打鱼游戏有存送优惠吗	咨询当下相关活动
请问BBIN没有反水没有优惠吗？	咨询当下相关活动
我有什么免费礼金	咨询当下相关活动
帮我看看有什么优惠可以领取	咨询当下相关活动
你可以帮我看看我现在有啥优惠可以拿？	咨询当下相关活动
您好我充值了1万没到账	存款相关问题
为什么我刚刚支付宝转银行卡一直不到账呢	存款相关问题
支付宝存款显示到账成功，怎么没有啊	存款相关问题
我存款给这个为什么还没到账	存款相关问题
汇款到账，账户没钱	存款相关问题
我存款成功为什么我没有到账啊	存款相关问题
我支付宝转账300怎么还没到账	存款相关问题
我充了100元以几个小时了，咋没有到帐。	存款相关问题
我刚刚用云闪付支付了100，咋不到账	存款相关问题
云闪付了100元，钱呢	存款相关问题
云闪付未到账	存款相关问题
充值未到账	存款相关问题
你好，帮我查下我存的款怎么还没到账	存款相关问题
几个小时钱没有到账哦，用支付宝扫的	存款相关问题
支付宝扫码存款未到账	存款相关问题
我的存款怎么还没到帐	存款相关问题
我刚刚微信转到银行卡成功了怎么还没到账！	存款相关问题
我用微信充值成功了怎么没到账？	存款相关问题
微信转账成功没有到账？	存款相关问题
我刚才充值的500到账怎么这么慢	存款相关问题
我微信冲了20怎么还没有到账	存款相关问题
存钱还不到账	存款相关问题
你好我刚刚支付宝转账3000为什么还没到账？	存款相关问题
你好！请帮我查一下我先用支付宝转的账咋都还没有到账喃！	存款相关问题
微信冲了没有到账	存款相关问题
我没办法存款玩怎么办	存款相关问题
充值了太慢了	存款相关问题
你好我转的还没到游戏账号	存款相关问题
微信，支付宝，怎么存不了款啊	存款相关问题
用微信咋存款啊？	存款相关问题
微信冲没有到账	存款相关问题
手机银行扫码，没到账	存款相关问题
怎么充的钱这么久不到账户里	存款相关问题
现在你们平台支付宝充值不了吗	存款相关问题
存的钱没到	存款相关问题
钱为什么不到账，存款	存款相关问题
充值了半个小时还没到账？	存款相关问题
你好，我云闪付存的钱没到账	存款相关问题
支付宝转账到账平台上没有钱	存款相关问题
扫码没到账	存款相关问题
支付宝显示到账了！怎么没有到主账户	存款相关问题
支付宝扫二维码转账怎么提示无法使用	存款相关问题
转账异常，无法使用支付宝转账	存款相关问题
云闪付支付成功又没到账	存款相关问题
你们怎么回事？久安冲值时时不到账	存款相关问题
我上了分多久了都没到你帮我看看	存款相关问题
我存的钱没到主账号	存款相关问题
我微信转银行卡的钱没到主账号	存款相关问题
存钱怎么还没到	存款相关问题
支付宝转账成功，账号没有	存款相关问题
支付宝扫码存款怎么还没到账	存款相关问题
现在微信充不了，还有其他办法吗	存款相关问题
我刚网银转账了，怎么没到帐	存款相关问题
网银转账没到账	存款相关问题
钱转了怎么那么久还没进账号	存款相关问题
刚刚充值账号没收到钱哦	存款相关问题
QQ充值怎么充不了	存款相关问题
秒存未到账	存款相关问题
我刚刚秒存还没到账	存款相关问题
刚刚的秒存呢	存款相关问题
秒存	存款相关问题
我刚刚的秒存没到	存款相关问题
不是秒存吗	存款相关问题
不是说的秒存吗？钱呢	存款相关问题
说好的秒存呢	存款相关问题
未到账	存款相关问题
未到帐	存款相关问题
存款未到帐	存款相关问题
存款未到账	存款相关问题
存款没到帐	存款相关问题
存款未到账	存款相关问题
入款未到账	存款相关问题
入款未到帐	存款相关问题
银行扫码存款了，好久可以到账	存款相关问题
支付宝秒存还没到	存款相关问题
支付宝转账怎么还没到账	存款相关问题
为什么我存款不了呢	存款相关问题
我充值没到	存款相关问题
存款账号哪里看	存款相关问题
充值了一直没到账	存款相关问题
我的存款没有到账	存款相关问题
刚才充了几十怎么还不到啊	存款相关问题
微信转账现在用不了？	存款相关问题
为什么一直就存不上钱呢？	存款相关问题
云闪支付这么还没到账	存款相关问题
充值了咋没到了	存款相关问题
充值不支持信用卡吗	存款相关问题
云闪付没到帐	存款相关问题
我只有支付宝还有微信可以用	存款相关问题
我银联扫码怎么还没有到账	存款相关问题
怎么微信秒存不了	存款相关问题
请问为微信转账怎么不能使用呢	存款相关问题
我转账成功了，钱没有到我账户	存款相关问题
存款迟迟没有	存款相关问题
支付宝存款没到帐	存款相关问题
转账到账半天了，怎么账户上没钱	存款相关问题
我用支付宝充值的钱没有到账	存款相关问题
网银扫码没有到账	存款相关问题
存款没到	存款相关问题
有能上分的方式吗？	存款相关问题
查一下我存款还没到	存款相关问题
微信怎么存款	存款相关问题
银行扫码没到账	存款相关问题
微信扫码付款没到	存款相关问题
支付宝怎么存	存款相关问题
支付宝秒存怎么这么久没到账啊？	存款相关问题
我有笔存款未到账	存款相关问题
存款怎么这么久了还没有到帐	存款相关问题
我充值还没到账	存款相关问题
我刚刚存款怎么没有到	存款相关问题
充值了一直不到账	存款相关问题
我存款怎么半天不到账	存款相关问题
我刚刚微信转账存款怎么没有到账呢？	存款相关问题
信用卡能充值吗	存款相关问题
帮我查询下云闪付成功还没到账	存款相关问题
存不了钱	存款相关问题
微信怎么没法存款	存款相关问题
微信转账怎么不能充值呢？	存款相关问题
微信存款怎么存不上	存款相关问题
可以花呗吗	存款相关问题
京东白条呢	存款相关问题
银行卡在线支付存款没到账	存款相关问题
支付宝存钱咋还没到	存款相关问题
我的存款怎么没到账	存款相关问题
微信快捷支付不到账	存款相关问题
我有一笔存款没有到账	存款相关问题
支付宝充值没到账	存款相关问题
我的存款怎么没到了	存款相关问题
我的存款还没处理好吗？	存款相关问题
怎么支付宝转账成功了为什么还没到账	存款相关问题
我存款到账了 你们没给我上分	存款相关问题
我微信快捷转账  咋没到账呢	存款相关问题
支持信用卡付款吗	存款相关问题
可以用信用卡吗	存款相关问题
信用卡可以支付吗	存款相关问题
信用卡可以吗	存款相关问题
蚂蚁花呗可以吗	存款相关问题
用花呗可以吗	存款相关问题
花呗支付可以吗	存款相关问题
支持花呗吗	存款相关问题
京东白条可以吗	存款相关问题
用京东白条可以吗	存款相关问题
京东白条可以支付吗	存款相关问题
支持白条吗	存款相关问题
存不起秒存	存款相关问题
取消我的微信存款订单	存款相关问题
作废我的微信订单	存款相关问题
微信订单作废	存款相关问题
充值什么时候到账	存款相关问题
推荐pt的游戏	游戏咨询
我pt的游戏投注记录怎么没有呢	游戏咨询
推荐一下老虎机	游戏咨询
什么游戏好玩？	游戏咨询
哪个游戏好玩？	游戏咨询
什么老虎机出分	游戏咨询
SW出分的游戏	游戏咨询
今天的推荐游戏有哪些啊	游戏咨询
出分推荐	游戏咨询
推荐下优质游戏吧	游戏咨询
Pt客户端前面要加什么	游戏咨询
赔付有问题	游戏咨询
游戏有问题	游戏咨询
今天PT那款游戏爆分	游戏咨询
帮我查下今天的投注额	游戏咨询
查询投注额	游戏咨询
帮我查下投注额	游戏咨询
我投注额多少	游戏咨询
查下我流水	刷新流水
帮我查下流水多少	刷新流水
我今天流水多少	刷新流水
我今天投注多少	游戏咨询
我今天投注额多少	游戏咨询
是不是登录前面要加那个字母	游戏咨询
今天出分游戏是什么啊？	游戏咨询
今天什么游戏放分	游戏咨询
体育怎么投注	游戏咨询
体育怎么玩	游戏咨询
沙巴体育注单怎么看	游戏咨询
体育注单怎么看	游戏咨询
赔付有问题	游戏咨询
你这赔付有问题阿	游戏咨询
赔付不对	游戏咨询
帮我查查赔付	游戏咨询
游戏赔付不对	游戏咨询
帐号前面加什么	游戏咨询
前缀加什么	游戏咨询
登入加什么	游戏咨询
账号加什么	游戏咨询
前缀多少	游戏咨询
前缀是什么	游戏咨询
登入前面加什么	游戏咨询
游戏一直断	游戏咨询
进不去啊游戏断了	游戏咨询
游戏卡啊	游戏咨询
游戏好卡阿	游戏咨询
游戏断了进不去啊	游戏咨询
游戏怎么断了	游戏咨询
好端端的怎么转着就断线了	游戏咨询
游戏转着转着就断了	游戏咨询
进入免费游戏就断了	游戏咨询
免费游戏局断了	游戏咨询
好不容易玩到免费就断线	游戏咨询
转免费就断线	游戏咨询
转到一半就断了	游戏咨询
一进免费就断线	游戏咨询
玩到一半就断了	游戏咨询
帮我查投注额	游戏咨询
帮我查流水	游戏咨询
体育	游戏咨询
体育怎么玩	游戏咨询
体育好玩吗	游戏咨询
你们家有体育吗	游戏咨询
体育哪里查记录	游戏咨询
体育哪里查注单	游戏咨询
怎么老掉线啊	游戏咨询
请问pt客户端账号前面需要加什么吗	游戏咨询
有一场比赛显示结算，但是余额还没到账，是不是延时？	游戏咨询
pt哪个出分？	游戏咨询
帮我查下总投注额	游戏咨询
那个糖果派对在哪里	游戏咨询
那个连活夺宝在哪里	游戏咨询
你们有糖果派对吗	游戏咨询
你们有连环夺宝吗	游戏咨询
有糖果派对吗	游戏咨询
有连环夺宝吗	游戏咨询
PT客户端登录前面要加什么字母	游戏咨询
登录pt客户端，账号前缀要加什么	游戏咨询
我刚下了客户端，填写账号的时候怎么填写	游戏咨询
PT客服端登录开头字母是什么	游戏咨询
PT手机客户端前加什么	游戏咨询
请问下PT客户端登录 用户名前面是不是要加什么字母呢？	游戏咨询
pt手机客户端登陆前面加什么	游戏咨询
现在pt什么游戏下分呢？	游戏咨询
pt有出分游戏吗	游戏咨询
pt客户端登陆前面要添加字母几啊	游戏咨询
pt客户端登陆加那个字母？	游戏咨询
客户端前面要加什么字母	游戏咨询
出分游戏推荐一下	游戏咨询
哪个游戏好打	游戏咨询
PT客服端前面加什么	游戏咨询
pt什么出分游戏	游戏咨询
投注记录在哪里看 	游戏咨询
游戏记录哪里查	游戏咨询
游戏记录哪里看	游戏咨询
投注记录哪里查	游戏咨询
今日出分游戏推荐	游戏咨询
这游戏是不能玩了吗	游戏进不去
游戏不能玩	游戏进不去
游戏怎么不能玩	游戏进不去
游戏卡成这样	游戏进不去
你这游戏卡阿	游戏进不去
游戏好卡阿	游戏进不去
这游戏真卡	游戏进不去
游戏怎么这么卡	游戏进不去
游戏卡成这样	游戏进不去
为什么手机pT游戏进不去	游戏进不去
pt游戏进不去 提示错误代码	游戏进不去
游戏为啥玩不了	游戏进不去
游戏出现错误	游戏进不去
为啥进PT老虎机，进度条卡住不动	游戏进不去
游戏怎么进不去	游戏进不去
登录密码忘记了	忘记密码
密码忘记了	忘记密码
我密码忘了，手机又换了，怎么办	忘记密码
你好我是刚注册的忘了密码	忘记密码
找回密码	忘记密码
密码忘了怎么办	忘记密码
密码忘记了	忘记密码
账号密码输错锁定了	忘记密码
找下登录密码	忘记密码
密码不记得了	忘记密码
麻烦帮我改下密码，我忘了	忘记密码
我登录密码忘记了	忘记密码
我忘记了，登陆密码？	忘记密码
我的游戏密码忘记了	忘记密码
密码忘了怎么找回	忘记密码
我忘记登录密码了	忘记密码
密码忘了好像	忘记密码
找回密码	忘记密码
我密码忘了，手机号不用了，怎么找回	忘记密码
我密码忘了，手机号不用了	忘记密码
忘了密码	忘记密码
我账号登录不了忘了密码了，我又换了手机号码了，然后邮箱密码也忘了，怎么办？	忘记密码
我要优惠券	红包咨询
申请个红包输太多了	红包咨询
申请个转运红包	红包咨询
申请个红包输太多了	红包咨询
申请个转运金	红包咨询
帮我转转运，两个月背，可以申请个红包吗？	红包咨询
帮忙申请个红包吧	红包咨询
麻烦你帮我申请一下转运红包！	红包咨询
有红包领没，送个红包用哈	红包咨询
申请红包优惠券	红包咨询
帮我申请个转运红啊	红包咨询
有没有红包看一下	红包咨询
送个转运红包嘛	红包咨询
申请个红包优惠券吗	红包咨询
能不能帮我申请一个红包	红包咨询
我想申请一个转运红包可以吗	红包咨询
红包优惠卷怎么申请	红包咨询
申请转运金	红包咨询
申请下转运红包	红包咨询
美女送张优惠券	红包咨询
特邀有彩金送吗？	红包咨询
优惠券怎么申请	红包咨询
给我送点彩金嘛美女	红包咨询
特邀彩金怎么领取	红包咨询
我的优惠券怎么显示已经用过了呢	红包咨询
忘了账号和密码怎么弄	账号解锁、忘记账号
账号忘记	账号解锁、忘记账号
账号已锁	账号解锁、忘记账号
帮我解冻结的号	账号解锁、忘记账号
亲我忘记了账号和密码	账号解锁、忘记账号
你好帐号冻结了	账号解锁、忘记账号
忘记账户了	账号解锁、忘记账号
忘记帐号了	账号解锁、忘记账号
帮我查一下游戏账号	账号解锁、忘记账号
游戏帐号忘了	账号解锁、忘记账号
游戏帐号多少	账号解锁、忘记账号
帮我解冻	账号解锁、忘记账号
账号被锁怎么办	账号解锁、忘记账号
我的账号忘记了我能用手机号找回账号吗？	账号解锁、忘记账号
我的账号密码忘了	账号解锁、忘记账号
你好我帐号被冻结了	账号解锁、忘记账号
忘记登陆账号	账号解锁、忘记账号
忘记登陆账号	账号解锁、忘记账号
帮忙找回账号和密码	账号解锁、忘记账号
怎么冻结了	账号解锁、忘记账号
我的账号为什么会被禁用呢	账号解锁、忘记账号
请问我账号多少	账号解锁、忘记账号
我要找回我的账号密码	账号解锁、忘记账号
为什么我的帐号登不上了	账号解锁、忘记账号
我帐号被锁了，麻烦解一下	账号解锁、忘记账号
我忘了账号是多少了	账号解锁、忘记账号
我的账号不能登陆	账号解锁、忘记账号
我帐号被锁了	账号解锁、忘记账号
我退出去了又搞忘了账号是多少啊	账号解锁、忘记账号
我忘了账号	账号解锁、忘记账号
用手机登录密码错误你们给锁死，帮忙解锁	账号解锁、忘记账号
账号临时冻结	账号解锁、忘记账号
帮忙解冻	账号解锁、忘记账号
我不小心输错密码多次导致账户被锁住了	账号解锁、忘记账号
账号和密码怎么找回来？	账号解锁、忘记账号
PT客户端冻结了	账号解锁、忘记账号
账号和密码都忘记了	账号解锁、忘记账号
帐号被锁定	账号解锁、忘记账号
查询下我的账号	账号解锁、忘记账号
登录帐号忘记了	账号解锁、忘记账号
我账号怎么被禁用了	账号解锁、忘记账号
我的账号怎么被冻结了	账号解锁、忘记账号
帐号在pt手机客户端被冻结了	账号解锁、忘记账号
能不能帮我解除下账号	账号解锁、忘记账号
不记得账号了怎么找？	账号解锁、忘记账号
为什么我刚冲值了准备游戏，结果显示帐号冻结	账号解锁、忘记账号
为什么又被冻结了	账号解锁、忘记账号
我账号锁了，麻烦帮我解锁	账号解锁、忘记账号
我账号被冻结了	账号解锁、忘记账号
帐号忘记了	账号解锁、忘记账号
忘记账号了，麻烦查一下	账号解锁、忘记账号
为什么我的帐号冻结呢了	账号解锁、忘记账号
玩家被冻结什么意思	账号解锁、忘记账号
账号锁定了	账号解锁、忘记账号
为什么我的账号被禁用	账号解锁、忘记账号
账号解冻	账号解锁、忘记账号
账号临时冻结了	账号解锁、忘记账号
不记得账号	账号解锁、忘记账号
我账号忘记了可以找回吗？	账号解锁、忘记账号
账号被冻结怎么回事	账号解锁、忘记账号
转账了但是PT里没分	转账咨询
我转账到PT转不进去	转账咨询
为什么户内转不了账？	转账咨询
户内怎么转不了账？所有的游戏平台都转不了	转账咨询
我想问一下我账内转账为什么转不了主账户	转账咨询
怎么不能转入pt	转账咨询
怎么转账NT平台啊	转账咨询
市场部没有在线客服吗	官网及账号问题
我把账号忘记了	账号解锁、忘记账号
修改账号绑定电话号码	修改账号资料
可以用手机号找账号吗	账号解锁、忘记账号
可以用注册邮箱找账号吗	账号解锁、忘记账号
我刚刚的沙巴订单是什么情况	游戏咨询
游戏咋进不去	游戏进不去
生日当天有生日彩金领取吗	VIP咨询
我想解绑卡	密保银行卡解绑
我的pt账户冻结了	账号解锁、忘记账号
我提款密码忘记了	提款相关问题
我的生日礼金是不是可以领啊	VIP咨询
优惠卷怎么用？	红包咨询
qt上面的游戏，为什么玩不了了	游戏进不去
已经清除缓存了	官网及账号问题
已经使用谷歌了	官网及账号问题
我已经清缓存啦，还是不行	官网及账号问题
我已经换谷歌了，还是不行	官网及账号问题
我用的就是谷歌	官网及账号问题
我刚刚已经清缓存啦	官网及账号问题
我早就换谷歌了	官网及账号问题
我早就清缓存了	官网及账号问题
已经清缓存了	官网及账号问题
已经用谷歌了	官网及账号问题
我现在可以参加什么活动	咨询当下相关活动
我现在可以参与什么优惠	咨询当下相关活动
您好，我们是做广告代发的~ 需要推广吗？	官网及账号问题
提款一直未审核	提款相关问题
体验金赢到多少可以取款	体验金咨询
专属客服的微信	官网及账号问题
体验金赠送28元提款限制要求	体验金咨询
新用户有没有体验金	体验金咨询
我没有领取救援金为什么显示我领了	救援金咨询
怎么充值	存款相关问题
号冻结了，什么时候能开	账号解锁、忘记账号
为什么沙巴体育进不去了	游戏进不去
怎么沙巴体育打不开	游戏进不去
我帐号锁住了	账号解锁、忘记账号
维护了吗	系统维护状况说明
派彩不对啊	游戏咨询
这派彩不正常	游戏咨询
游戏派彩不对	游戏咨询
游戏赢的钱少了	游戏咨询
游戏赢的钱不对	游戏咨询
你这个辣鸡	抱怨
辣鸡	抱怨
辣鸡平台	抱怨
你这个垃圾	抱怨
你们都是垃圾	抱怨
垃圾平台	抱怨
游戏进不去了？	游戏进不去
网址打不开了	不能登录
怎么进不了沙巴体育	游戏进不去
怎么登录不了	不能登录
取款密码忘了	提款相关问题
刚注册的会员，是不是要送88？	救援金咨询
