为什么账户里的钱转不进pt	转账咨询
现在不能户内转账吗	转账咨询
为什么我中心钱包的钱转不出来	转账咨询
户内转账转不了	转账咨询
请问老虎机钱包，包含哪几个电子平台	转账咨询
老虎机钱包是什么游戏	转账咨询
钱在老虎机包里可以玩什么游戏	转账咨询
我申请的体验金在老虎机钱包里面，这个钱包对应的是哪个电子游戏平台啊	转账咨询
老虎机钱包能玩哪个游戏?	转账咨询
帮我查一下游戏账号	账号解锁、忘记账号
不记得用户名了	账号解锁、忘记账号
刚才注册的游戏平台我记不得游戏账号了	账号解锁、忘记账号
账号被冻结	账号解锁、忘记账号
你好账户忘了	账号解锁、忘记账号
我忘记了我的账号怎么办	账号解锁、忘记账号
帮我解冻账号	账号解锁、忘记账号
我的账号忘记了	账号解锁、忘记账号
帐号忘记	账号解锁、忘记账号
你帮我查一下，我在你家的帐号行吗	账号解锁、忘记账号
我账号密码忘了，只知道银行卡号	账号解锁、忘记账号
账号锁了	账号解锁、忘记账号
账号锁定	账号解锁、忘记账号
我忘了我账号是多少了	账号解锁、忘记账号
提示我的账户冻结了	账号解锁、忘记账号
请帮我把账号解冻	账号解锁、忘记账号
你先帮我把账号解冻先	账号解锁、忘记账号
账户冻结了	账号解锁、忘记账号
忘记游戏账号怎么办	账号解锁、忘记账号
找回账号	账号解锁、忘记账号
忘记账号	账号解锁、忘记账号
我账号忘记了，可以帮我查一下吗？	账号解锁、忘记账号
解锁账户	账号解锁、忘记账号
我的账号被冻结了	账号解锁、忘记账号
能帮我查询下我的账号是多少吗？	账号解锁、忘记账号
请帮我找回密码和账号	账号解锁、忘记账号
请问账户临时被冻结是啥意思？	账号解锁、忘记账号
解锁下账户	账号解锁、忘记账号
帐号锁住了	账号解锁、忘记账号
查询我的账号我账号不记得了	账号解锁、忘记账号
我帐号忘记了	账号解锁、忘记账号
看看我的登录号多少？	账号解锁、忘记账号
我账号忘记了	账号解锁、忘记账号
我的账号冻结了	账号解锁、忘记账号
帐号被冻结	账号解锁、忘记账号
能找下我账号多少	账号解锁、忘记账号
我帐号锁了	账号解锁、忘记账号
我帐号锁了	账号解锁、忘记账号
为什么我被禁用？	账号解锁、忘记账号
我PT游戏帐号怎么冻结了呢	账号解锁、忘记账号
我的帐号怎么给冻结了	账号解锁、忘记账号
我的账户和密码都忘了能找回来么	账号解锁、忘记账号
忘记帐号和密码	账号解锁、忘记账号
我忘记我账号了	账号解锁、忘记账号
账号密码不记得了	账号解锁、忘记账号
帐号冻结	账号解锁、忘记账号
我把账号密码忘了	账号解锁、忘记账号
我的游戏账号里面的pt平台，怎么还锁上了？	账号解锁、忘记账号
忘记账号了	账号解锁、忘记账号
账号跟密码都忘记了	账号解锁、忘记账号
申请个红包	红包咨询
申请转运红包	红包咨询
能不能给个红包啊	红包咨询
来个转运红包	红包咨询
输了一万多给我个红包	红包咨询
特邀彩金	红包咨询
红包优惠码为什么不能用	红包咨询
申请转运红包	红包咨询
给我申请一个红包嘛	红包咨询
我领取红包优惠	红包咨询
优惠代码未审核是什么意思	红包咨询
红包优惠券  那个优惠代码没审核是什么意思啊	红包咨询
给我送个优惠券呗	红包咨询
给我申请免费转运红包	红包咨询
转运红包给一个吧	红包咨询
请问一下优惠券代码是啥	红包咨询
来个转运红包	红包咨询
我有红包优惠券吗	红包咨询
还有没有转运红包了	红包咨询
申请转运红包	红包咨询
我可以申请哪些优惠红包	红包咨询
为什么我的红包卷兑换不了	红包咨询
优惠代码错误	红包咨询
能给我申请一下转运红包吗？	红包咨询
忘记密码	忘记密码
密码忘记	忘记密码
我密码忘了怎么办	忘记密码
我密码忘了	忘记密码
帮我找回一下登录密码	忘记密码
密码错误太多回被锁了	忘记密码
我的密码忘记了怎么找回来	忘记密码
我密码锁了，请帮我解一下	忘记密码
我密码忘了，请帮我	忘记密码
忘记登录密码	忘记密码
密码忘记了	忘记密码
我想找回密码	忘记密码
忘记登录密码	忘记密码
密码忘了	忘记密码
密码忘啦	忘记密码
把我密码改了	忘记密码
我不记得现在密码多少了	忘记密码
忘记密码了	忘记密码
我忘记了登录密码	忘记密码
登录密码忘了	忘记密码
我游戏帐号记不到密码了	忘记密码
我忘记密码了怎么找回	忘记密码
PNG怎么动不了	游戏进不去
一进免费就断线	游戏进不去
游戏怎么这么卡	游戏进不去
我电脑玩卡，还换手机玩，免费游戏就没有了	游戏进不去
我免费游戏到那去了	游戏进不去
免费游戏中卡死了	游戏进不去
pt为啥登不上	游戏进不去
你们网站不能玩沙巴体育了吗	游戏进不去
PS的游戏怎么进不去？	游戏进不去
所有网址都无法进入沙巴体育	游戏进不去
为什么我pt游戏场不能玩啊？	游戏进不去
怎么进入不了游戏？	游戏进不去
游戏错误玩不了	游戏进不去
为什么网页版的玩不成	游戏进不去
为什么苹果机玩不了游戏	游戏进不去
免费游戏怎么不动了	游戏进不去
我从其他平台来的，给个试玩吧	游戏咨询
先试玩在考虑要不要注册	游戏咨询
你们有彩票吗	游戏咨询
有彩票游戏嘛?	游戏咨询
我刚刚的球赛注单哪看	游戏咨询
我玩冰球突破怎么中奖了没给我分	游戏咨询
中奖了给的钱不对	游戏咨询
游戏太吃分了吧	游戏咨询
给个试玩吧	游戏咨询
PT手机客户端登陆账号前面加什么字母	游戏咨询
介绍个能出分的游戏	游戏咨询
手机pt客户端登陆时需要加前缀吗？	游戏咨询
登录手机PT客户端账号加什么	游戏咨询
请问今晚PT出分游戏是什么呢？	游戏咨询
PT出分游戏推荐一下	游戏咨询
现在哪个pt爆分	游戏咨询
请给我推荐下游戏	游戏咨询
pt手机客服端账号前面加什么	游戏咨询
登录前面加啥字母	游戏咨询
帮我看看出分游戏吧	游戏咨询
请帮我看看出分游戏谢谢	游戏咨询
PT现在哪个游戏出分高	游戏咨询
你家的这游戏有没有个出分的	游戏咨询
怎么能查到游戏记录	游戏咨询
今天推荐几个出分的游戏	游戏咨询
在客户端上前面要加什么	游戏咨询
PT用APP登录账号前面加什么	游戏咨询
pt游戏前面加啥能登录啊	游戏咨询
请问您，PT客户端前面加什么？	游戏咨询
pt手机客户端登陆前面加什么字母	游戏咨询
PT电子登录加上什么	游戏咨询
pt现在哪个游戏肯出分？	游戏咨询
登陆PT客户端前面加字母吗	游戏咨询
pt登录器加什么	游戏咨询
那个游戏出分	游戏咨询
pt场什么游戏出分	游戏咨询
手机登陆PT客户端是不是前面要加什么？	游戏咨询
PT前缀是什么	游戏咨询
手续费	提款相关问题
花呗可以用吗	存款相关问题
怎么存不起钱了呢	存款相关问题
怎不能存呢	存款相关问题
为啥不能存	存款相关问题
为啥不能存款	存款相关问题
怎么不能存款	存款相关问题
都存20分钟了还没到账？	存款相关问题
没有到账帮我查一下	存款相关问题
我的存款怎么还没到账呢	存款相关问题
我刚才充值五十显示到账了到账号余额没钱啊	存款相关问题
存款没有到	存款相关问题
支付宝转账还没有到帐？	存款相关问题
帮我看下充值没到账	存款相关问题
充的钱没有到账	存款相关问题
怎么我的存款还没到账	存款相关问题
支付宝转存未到帐	存款相关问题
现在可以微信充值吗	存款相关问题
存款半小时为什么还没有到	存款相关问题
怎么钱还没到账我这都显示冲上了	存款相关问题
帮我查一下钱充上了怎么还没到	存款相关问题
我存的钱到账了为什么没有到我游戏账号上	存款相关问题
充钱怎么还没到?	存款相关问题
为什么我充值了支付宝，还没到账	存款相关问题
麻烦你查一下存款怎么还没到账了	存款相关问题
我钱咋还没到账	存款相关问题
支付宝秒存没到账	存款相关问题
存款成功了，我号上怎么没有	存款相关问题
为什么我的存款现在还没到	存款相关问题
存款没到	存款相关问题
存款半个小时还不到账？	存款相关问题
怎么充钱	存款相关问题
请问我的存款什么时候能到账啊？	存款相关问题
微信能转账充钱吗？	存款相关问题
充值没有到	存款相关问题
有个存款一直不到	存款相关问题
我存款不到账呢	存款相关问题
我充值怎么不会到	存款相关问题
帮我查一下存款	存款相关问题
还有什么办法存款	存款相关问题
我刚刚充值一百元怎么还没到账	存款相关问题
帮我看下我的存款怎么还没到啊	存款相关问题
存款存不上怎么办	存款相关问题
帮我看一下我的存款怎么还没到	存款相关问题
支付宝转了还没到账？	存款相关问题
网银支付没有到账	存款相关问题
刚充的钱  咋不上账	存款相关问题
刚刚存款上分还没到账	存款相关问题
存款多久会到	存款相关问题
手机银行转账未到账	存款相关问题
微信不可以支付吗	存款相关问题
你好我刚才充值的钱什么时候到帐	存款相关问题
钱咋不到账呢	存款相关问题
没有支付宝扫码支付？	存款相关问题
我冲的钱怎么还没到	存款相关问题
存款怎么这么久还没到账呢？	存款相关问题
我充的钱怎么还没到	存款相关问题
请给我查一下支付宝转账	存款相关问题
微信转账可以吗	存款相关问题
刚才买币了没到账	存款相关问题
我存款已经存了怎么不到帐	存款相关问题
请问我现在能用网银在线支付充值吗？	存款相关问题
微信不能支付了吗？	存款相关问题
为什么我存款不到账呢	存款相关问题
怎么存款不到账呢	存款相关问题
我微信转账未到游戏帐上	存款相关问题
存款为什么还没到	存款相关问题
我用支付宝转账存款，没有到账	存款相关问题
点卡充值没到账	存款相关问题
我冲钱没到	存款相关问题
充值了但号上没有钱	存款相关问题
怎么我支付宝转账充值的钱还没到账	存款相关问题
帮我查下存款	存款相关问题
我的存款怎么没到呀	存款相关问题
我的秒存现在还没到账	存款相关问题
我存款怎么半天都还没有到	存款相关问题
你帮我查一下充值还没到账	存款相关问题
我的存款怎么还没有到账呢	存款相关问题
久安钱包哪里下	存款相关问题
我存的钱怎么没到账	存款相关问题
我的存款怎么还没到账	存款相关问题
问一下我存款怎么还不到账啊？	存款相关问题
我充了款为什么还没有到账了	存款相关问题
我的存款没有到账？	存款相关问题
我存的钱，怎么沒有看到账啊？	存款相关问题
充值为什么还没有到账	存款相关问题
支付宝秒存没到账	存款相关问题
我充值的钱怎么没到账	存款相关问题
我充了钱怎么没到帐	存款相关问题
银联扫码没到账	存款相关问题
存钱没到账	存款相关问题
支付宝充值没到账	存款相关问题
我的金额怎么还没有到账了	存款相关问题
网银冲值为什么还没到账	存款相关问题
我支付宝转账了没到账	存款相关问题
我冲完的钱为什么没到账	存款相关问题
扫码未到账	存款相关问题
我有几款存款没到账	存款相关问题
为什么我用微信秒存，告诉我活跃度不足	存款相关问题
可以用花呗上分吗？	存款相关问题
怎么我的存款还没有到	存款相关问题
我的秒存没有到账	存款相关问题
我的存款怎么还没有到	存款相关问题
我网银转账未到账	存款相关问题
怎么充值	存款相关问题
它说我活跃度不足，请选择其它通道	存款相关问题
我充值成功了、怎么还没有到账	存款相关问题
我的存款怎么还没到账啊	存款相关问题
我存款怎么还没到？	存款相关问题
微信扫码充值怎么充?	存款相关问题
我怎么存款没到了？	存款相关问题
存款半天都不到账	存款相关问题
充值怎么还没到账？	存款相关问题
怎么我充值的还没到呢	存款相关问题
我的存款怎么还不到	存款相关问题
银行扫码没到账	存款相关问题
充值成功没到账	存款相关问题
10分钟了，刚充的钱还没到帐	存款相关问题
充值未到账	存款相关问题
直接帮我查我能领什么	咨询当下相关活动
看看我的账号有什么可以领取的彩金或奖金之类的	咨询当下相关活动
看看我有啥可以领取的优惠	咨询当下相关活动
那你看我现在还能领取什么礼金呢	咨询当下相关活动
你给我帐号刷新一次流水	刷新流水
帮我刷新pt流水	刷新流水
帮我刷下流水我要转账	刷新流水
帮我刷新下流水	刷新流水
刷新下流水	刷新流水
帮我查下PT流水，我要转账	刷新流水
帮我PT流水刷新一下	刷新流水
帮我查一下还差多少流水才可以转账	刷新流水
帮我查下流水	刷新流水
流水已经达标了转账时候还提示存在流水限制	刷新流水
刷新PT流水转账	刷新流水
问下PT还要多少流水	刷新流水
帮我刷新下pt流水	刷新流水
请问我pt的流水是多少啦	刷新流水
帮我刷新流水	刷新流水
请问我户内转账流水差多少	刷新流水
我想查一下我流水现在所有加起来	刷新流水
我要申请首存送100%	首存咨询
我要申请首存送100%申请不了	首存咨询
今天有首存100%的活动申请吗？	首存咨询
我想查下我去年5月分的交易明细	查询账号状态
能不能帮我查查我的存款记录是多少了	查询账号状态
我注册时姓名写错了	修改账号资料
在哪里可以绑定姓名	修改账号资料
帮我绑定姓名好嘛	修改账号资料
要绑定姓名怎么做	修改账号资料
我绑定时手机号输入错了	修改账号资料
姓名写错了可以改吗	修改账号资料
我的账号注册时的电话号换了	修改账号资料
改一下手机号	修改账号资料
能帮我改一下我手机号吗？	修改账号资料
原来的手机号丢了！换个手机号	修改账号资料
维护多久能好	系统维护状况说明
现在秒存维护吗	系统维护状况说明
今天中午的救援金要什么时候可以申请	救援金咨询
为什么我没有18号的救援金	救援金咨询
为什么没有救援金	救援金咨询
我要救援金	救援金咨询
几点发救援金？	救援金咨询
我没有救援金吗？	救援金咨询
过了12点怎么救援金还没有到	救援金咨询
救援金一般几点到账	救援金咨询
你们网没有救援金那	救援金咨询
救援什么时间发放？	救援金咨询
救援有什么条件？	救援金咨询
为什么我救援还没发啊？	救援金咨询
如何推荐好友	好友推荐
我刚刚注册的可是我重新登录就说我的账号不存在	官网及账号问题
我注册账户，名字被使用了	官网及账号问题
我提款代理佣金怎么还没有到达我的银行卡上呢？	官网及账号问题
注册不起来	官网及账号问题
重新注册需要什么手续	官网及账号问题
我注册说我信息有重复	官网及账号问题
我重新注册个账号可以吗	官网及账号问题
我从新注册个账号可以吗	官网及账号问题
专属客服怎么联系了	官网及账号问题
我的专属会员账号多少	官网及账号问题
请问网站推广有需要吗？	官网及账号问题
您好，广告推广需要吗？	官网及账号问题
怎么代理合作	官网及账号问题
怎么修改手机号码	官网及账号问题
有没有专属客服？	官网及账号问题
我代理账号多少？	官网及账号问题
怎么清除缓存	官网及账号问题
体验金多少可出款	体验金咨询
注册你们平台不是要送吗	体验金咨询
申请开户体验金12-88元	体验金咨询
注册你们平台要送体验分吗怎么没有送了	体验金咨询
怎么在的注册体验金提示领取成功但是没到呢	体验金咨询
我申请注册彩金	体验金咨询
注册送彩金吗	体验金咨询
注册彩金怎么申请	体验金咨询
注册有礼金吗	体验金咨询
不是说新会员有彩金吗	体验金咨询
为什么我的自助体验金没有	体验金咨询
我已经注册好啦，怎么领注册彩金啊	体验金咨询
怎么申请36彩金	体验金咨询
申请注册彩金	体验金咨询
新会员注册可以送彩金？	体验金咨询
你好！我刚才注册了你们网站会员，新开户的会员不是有体验彩金优惠吗？	体验金咨询
怎么申请新号彩金	体验金咨询
自助优惠里面没有开户体验金吗	体验金咨询
申请优惠手机号码收信息为什么收不到信息啊	体验金咨询
首次注册有体验金送吗	体验金咨询
注册彩金怎么领	体验金咨询
申请自助体验金里面哪个银行卡类型选不了	体验金咨询
怎么领取体验金？	体验金咨询
我收到短信通知注册送彩金	体验金咨询
新注册的号不送点分吗	体验金咨询
注册送彩金怎么领取	体验金咨询
我为啥不能领开户彩金	体验金咨询
体验金如何申请呢？	体验金咨询
如何申请体验金	体验金咨询
邮箱来短信说注册送彩金	体验金咨询
体验金怎么申请不下来	体验金咨询
体验金怎么申请不了	体验金咨询
注册有没活动	体验金咨询
体验金可以玩MG吗	体验金咨询
注册有礼金吗	体验金咨询
为什么我自助体验金领不了	体验金咨询
注册彩金怎么领？	体验金咨询
我领注册彩金为什么会提示重复银行卡信息呢	体验金咨询
体验金打多少流水，提款有限制吗	体验金咨询
怎么我手机收不到验证码啊	体验金咨询
体验金怎样申请	体验金咨询
为什么我领取体验金显示信息重复	体验金咨询
不说注册送彩金我怎么没有	体验金咨询
你们发邮件说注册送彩金	体验金咨询
怎么我新注册的没有彩金	体验金咨询
请问新注册会员有什么优惠	体验金咨询
我想问一下PT账号体验金能玩什么游戏	体验金咨询
是不是注册要送彩金	体验金咨询
有没有注册送彩金活动	体验金咨询
怎么收不到手机验证码呢	体验金咨询
注册送彩金怎么送	体验金咨询
体验金怎么申请	体验金咨询
这个注册账号有彩金吗？	体验金咨询
你们给我发的邮箱告诉注册账号给体验金	体验金咨询
怎么无法申请体验金	体验金咨询
注册账号咋没给我彩金啊	体验金咨询
收到邮件申请注册彩金	体验金咨询
我收到邮件邀请我注册送彩金	体验金咨询
注册有彩金嘛	体验金咨询
我要申请注册彩金	体验金咨询
看看我取款	提款相关问题
我的提款密码忘了怎么办	提款相关问题
提不了款?	提款相关问题
提款密码忘记了帮找一下呗	提款相关问题
晚上提款208元，到现在都没到卡上？	提款相关问题
提款还要审核吗	提款相关问题
提款密码忘了	提款相关问题
提款未到帐	提款相关问题
为什么不能提款	提款相关问题
提现审核需要多久呢？	提款相关问题
我的提款怎么这么久，都审核不了	提款相关问题
我的提款怎么一直都是待审核	提款相关问题
提现怎么还没到账	提款相关问题
今天提款一会了怎么还是待审核	提款相关问题
提现怎么还没到账啊	提款相关问题
怎么提款还没到账啊	提款相关问题
帮我取消提款	提款相关问题
提款什么时候到	提款相关问题
出款没到账	提款相关问题
你们到底给不给出款	提款相关问题
我提款怎么还没到？	提款相关问题
我提现那个取消了吗	提款相关问题
提款不是秒到吗？	提款相关问题
我出款了多久能到	提款相关问题
为什么我提款还没到？	提款相关问题
咋个提款现在都不到账	提款相关问题
我的提款怎么还没到	提款相关问题
忘记提款密码	提款相关问题
最低提款是有限制吗	提款相关问题
我提款了，什么时候到账啊	提款相关问题
出款好久了 怎么还是待审核	提款相关问题
申请提款要审核多久到账？	提款相关问题
为什么取款一直是待审核	提款相关问题
我申请的提款怎么不给处理	提款相关问题
你们提款要好久到账？	提款相关问题
我的提款密码忘记了怎么找回	提款相关问题
提现多久到账哦	提款相关问题
提款怎么审核了！不出款	提款相关问题
申请提款要多久	提款相关问题
帮我催下提款	提款相关问题
怎么我提款还没到	提款相关问题
提款怎么一直在审核？	提款相关问题
我提款半天没到账	提款相关问题
我提款很久，咋还没到帐	提款相关问题
我昨天提款怎么还在审核	提款相关问题
帮我看下我怎么提款还没到？	提款相关问题
我的提款怎么半天不到账呢	提款相关问题
我的提款怎么还在审核	提款相关问题
我可以取消提款不	提款相关问题
提款啥时候能到	提款相关问题
怎么提款还没有到	提款相关问题
我的提款怎么还在审核	提款相关问题
取款怎么没有到账	提款相关问题
怎么取款还没有审核	提款相关问题
为什么我的提款一个多小时还没通过呢？	提款相关问题
为什么我提款审核了，但是没有打款	提款相关问题
帮我取消提款	提款相关问题
我的提款怎么还没到？	提款相关问题
我的提款怎么还在审核	提款相关问题
提款怎么还在审核呢	提款相关问题
我的账号提款咋还没过来呀	提款相关问题
请问提现要审核多久呢？	提款相关问题
我的提款什么时候能到帐？	提款相关问题
之前申请的提款怎么还没审核	提款相关问题
能不能把我的提款取消，我还要玩游戏。	提款相关问题
把我的提款能给取消，我想继续玩游戏。	提款相关问题
怎么提款审核通过一直没执行呢	提款相关问题
提现审核一下	提款相关问题
我提的现怎么还没到	提款相关问题
我的提款怎么已审核了还没到账呢	提款相关问题
怎么我提现的钱没能到账	提款相关问题
提款怎么还没到账	提款相关问题
为什么我的提款被取消了	提款相关问题
我提了款为什么还没有到账了	提款相关问题
帮我取消提款	提款相关问题
把我的提款取消了 我要游戏	提款相关问题
怎么我提现的钱没到账	提款相关问题
请问我申请的提款为什么被取消啦	提款相关问题
你好我的提款一直没人处理呢	提款相关问题
提款不到账什么情况	提款相关问题
下款怎么下不了	提款相关问题
提款没有到账吗	提款相关问题
为什么提款不了	提款相关问题
提款延迟到账是怎么回事？	提款相关问题
提款怎么这么慢	提款相关问题
取款一般多久到账	提款相关问题
提款在处理了吗	提款相关问题
最低提款多少？	提款相关问题
请问提款什么时候到账	提款相关问题
为啥不给我提款	提款相关问题
给我催下提款	提款相关问题
投注反水，什么时候反	返水咨询
昨天的反水要到什么时候	返水咨询
我怎么申请反水	返水咨询
麻烦你帮我刷新一下反水记录	返水咨询
反水提不了，显示上一单洗码	返水咨询
提不了反水，一直显示上一次洗码中	返水咨询
什么时候反水	返水咨询
Pt洗码失败 说上一笔在审核	返水咨询
洗码审核中	返水咨询
银行卡错了怎么办	密保银行卡解绑
为什么建设银行绑定不了？	密保银行卡解绑
我想绑卡怎么不让我绑啊？	密保银行卡解绑
我找不到你们论坛在哪里	不能登录
论坛坏了	不能登录
论坛登不上	不能登录
论坛怎么进不去	不能登录
论坛登不进去	不能登录
网页被狭持	不能登录
网页怎么点不开	不能登录
进不去你们网站了	不能登录
官网是多少	不能登录
给我一个电脑可以登陆的网址	不能登录
你们最新官网是多少	不能登录
官网多少	不能登录
把官网发给我	不能登录
你们的网址是	不能登录
问问手机网址多少	不能登录
给个域名	不能登录
有最新网址吗	不能登录
官网是多少	不能登录
你们官网是多少	不能登录
网址告诉我一个	不能登录
电脑网址吗发下	不能登录
官网网址	不能登录
发网址我下	不能登录
怎么激活论坛的？	不能登录
我把我论坛账号密码忘了	不能登录
我进论坛的密码忘了	不能登录
电脑版网址是	不能登录
账号不能登录论坛	不能登录
可以给我官网网址吗？	不能登录
网页直接登陆也登录不上？	不能登录
最佳网址是什么？	不能登录
官网的网址是	不能登录
你们备用网址多少	不能登录
官网怎么进？	不能登录
网址多少	不能登录
你们官网是多少呀	不能登录
晋级有优惠吗	VIP咨询
请问下我生日礼金领取了怎么没有	VIP咨询
请问我刚刚领取生日礼金何时到账	VIP咨询
我申请了生日礼金	VIP咨询
生日礼金，在哪里看	VIP咨询
有生日彩金吗	VIP咨询
为什么生日礼金领不了	VIP咨询
申请生日礼金	VIP咨询
为什么我没有生日彩金领呢？	VIP咨询
升级不送彩金了？	VIP咨询
免费筹码怎么领	VIP咨询
我刚才晋级vip了为什么不能领取免费彩金	VIP咨询
可以帮我申请晋级吗	VIP咨询
你好我不能自助晋级	VIP咨询
可以帮我晋级吗？	VIP咨询
领取生日礼金	VIP咨询
晋级礼金什么时候送呢	VIP咨询
我有生日礼金吗	VIP咨询
pt有没有电脑端	app咨询
苹果手机可以下载pt 客服端么	app咨询
苹果客户端不能下载怎么回事	app咨询
在那里下载APP	app咨询
哪里下载app	app咨询
下载不了app的	app咨询
我要下载游戏APP	app咨询
客户端下载不了啊	app咨询
PT客服端下载	app咨询
有PT手机端下载方式吗？	app咨询
app在哪里下载	app咨询
为什么现在APP下载不了	app咨询
app下载不了	app咨询
下载app彩金怎么操作	app咨询
为什么我在app申请不了彩金优惠呢？	app咨询
app下载彩金	app咨询
申请下载app彩金	app咨询
pt安卓下载链接发我	app咨询
怎么下载app	app咨询
