我想删除账号	账号解锁、忘记账号
救援金	救援金咨询
救援金	救援金咨询
救援金	救援金咨询
我存款一直没到	存款相关问题
我提款一直等	提款相关问题
我存款怎么没有存进去	存款相关问题
我的转账转不进去	转账咨询
怎么一直断啊	游戏进不去
游戏一直断线	游戏进不去
我进了免费游戏就断线了，现在要进去游戏都不行	游戏进不去
注册送	体验金咨询
注册送什么	体验金咨询
游戏咨询	游戏咨询
说我上一笔洗码未审核	返水咨询
自助反水怎么显示上一笔反水未审核	返水咨询
注册送多少彩金	体验金咨询
帮我查下充了多少钱？	查询账号状态
您好我充值了1万没到账	存款相关问题
为什么我刚刚支付宝转银行卡一直不到账呢	存款相关问题
转账了但是PT里没分	转账咨询
代理账号忘了	官网及账号问题
支付宝存款显示到账成功，怎么没有啊	存款相关问题
我有个3000提款，撤销了	提款相关问题
取消我的提款	提款相关问题
把我的提款退回来	提款相关问题
我存款给这个为什么还没到账	存款相关问题
汇款到账，账户没钱	存款相关问题
我转账成功为什么我没有到账啊	转账咨询
我存款成功为什么我没有到账啊	存款相关问题
代理其他佣金提款了，什么时候可以到账啊	官网及账号问题
我支付宝转账300怎么还没到账	存款相关问题
这个不是有开户送吗	体验金咨询
体验金在哪领	体验金咨询
我刚才提款了，怎么一直没有到	提款相关问题
现在提款速度太差劲了	提款相关问题
绑我把游戏刷新一下现在看不到流水	刷新流水
绑我把游戏刷新一下 现在看不到流水	刷新流水
推荐pt的游戏	游戏咨询
推荐pt的游戏	游戏咨询
为什么总是注册不成功	官网及账号问题
体验金怎么用	体验金咨询
我刚刚用云闪付支付了100，咋不到账	存款相关问题
云闪付未到账	存款相关问题
充值未到账	存款相关问题
提现要审核几长时间	提款相关问题
你好，帮我查下我存的款怎么还没到账	存款相关问题
忘了账号和密码怎么弄	账号解锁、忘记账号
网站发来	不能登录
我提款怎么老在审核	提款相关问题
要怎么注册	官网及账号问题
今天什么游戏出分	游戏咨询
取消微信秒存订单	存款相关问题
我游戏怎么登不进去了	不能登录
我要优惠券	红包咨询
我pt怎么进不去	游戏进不去
几个小时钱没有到账哦，用支付宝扫的	存款相关问题
账号忘记	账号解锁、忘记账号
你好，我提款怎么提不了	提款相关问题
我的洗马怎么没钱啊	返水咨询
支付宝扫码存款未到账	存款相关问题
注册送彩金？	体验金咨询
我的存款怎么还没到帐	存款相关问题
我刚刚微信转到银行卡成功了怎么还没到账！	存款相关问题
账号已锁	账号解锁、忘记账号
我用微信充值成功了怎么没到账？	存款相关问题
帮我解冻结的号	账号解锁、忘记账号
提款怎么这么慢哦	提款相关问题
申请个红包输太多了	红包咨询
为什么我的提款申请一直被拒绝	提款相关问题
微信转账成功没有到账？	存款相关问题
你好我的提款没有处理吗	提款相关问题
我pt的游戏投注记录怎么没有呢	游戏咨询
申请个转运红包	红包咨询
登录密码忘记了	忘记密码
如何升级VIP3	VIP咨询
为什么提款取消	提款相关问题
我代理你们平台	官网及账号问题
户内转账转不出来	转账咨询
我刚才充值的500到账怎么这么慢	存款相关问题
我微信冲了20怎么还没有到账	存款相关问题
存钱还不到账	存款相关问题
你好我刚刚支付宝转账3000为什么还没到账？	存款相关问题
亲我忘记了账号和密码	账号解锁、忘记账号
我邮箱收到信息，说注册可以领取68元彩金，真的假	体验金咨询
你好！请帮我查一下我先用支付宝转的账咋都还没有到账喃！	存款相关问题
微信冲了没有到账	存款相关问题
我没办法存款玩怎么办	存款相关问题
充值了太慢了	存款相关问题
体验金在哪	体验金咨询
这两天我的救援金怎么没法呢？？	救援金咨询
我自助洗码怎么是0	返水咨询
注册彩金我咋没看到啊	体验金咨询
你好帐号冻结了，堤钱密石号望了	账号解锁、忘记账号
你好帐号冻结了	账号解锁、忘记账号
微信，支付宝，怎么存不了款啊	存款相关问题
用微信咋存款啊？	存款相关问题
把官网网址发过来	不能登录
无法存款	存款相关问题
活跃度不足	存款相关问题
支付宝转账到账平台上没有钱	存款相关问题
游戏推荐	游戏咨询
无法申请体验金	体验金咨询
扫码没到账	存款相关问题
收不到验证码	体验金咨询
系统提示信息重复&银行卡重复	体验金咨询
晋级的礼金金额	VIP咨询
怎么加微信客服	官网及账号问题
密码忘记了	忘记密码
存款没到账	存款相关问题
存款未到账	存款相关问题
存款没到	存款相关问题
注册	官网及账号问题
存款未到账	存款相关问题
我为什么不能存款	存款相关问题
活跃度不足	存款相关问题
忘记密码	忘记密码
申请转运红包	红包咨询
特邀红包	红包咨询
我的提款怎么被取消了	提款相关问题
我密保忘了	密保银行卡解绑
代理佣金提现一般多久到账	官网及账号问题
我想查一下账号状态	查询账号状态
我的账号被锁住了	查询账号状态
帮我转转运，两个月背，可以申请个红包吗？	红包咨询
大侠~您要询问的是哪种红包或是优惠券问题呢？说来小宝听听~ [link submit='特邀红包']	红包咨询
我的钱怎么没到账	存款相关问题
首存如何申请	首存咨询
存款未到账	存款相关问题
今天有什么活动	咨询当下相关活动
如何领取APP下载彩金	app咨询
如何领取APP下载彩金	体验金咨询
APP彩金是需要您自助申请的，小宝是摸也摸不到的阿！您只需要下载尊宝最新APP，下载成功后请点击ap	体验金咨询
支付宝显示到账了！怎么没有到主账户	存款相关问题
PT客户端前缀	游戏咨询
AG客户端要前缀吗	游戏咨询
我忘记密码了	提款相关问题
修改密码	提款相关问题
EBET客户端要前缀吗	游戏咨询
我的提款怎么被取消了	提款相关问题
我的钱怎么没到账	存款相关问题
户内转账未到账	存款相关问题
提款没到	提款相关问题
请问我的提款怎么一直在审核？？	提款相关问题
我没有领取到救援金	救援金咨询
存款没到	提款相关问题
申请转运红包	红包咨询
转运红包	红包咨询
今天什么游戏好玩	游戏咨询
真人百家乐	游戏咨询
电动老虎机	游戏咨询
我想查询游戏记录	游戏咨询
连环夺宝	游戏咨询
网址	不能登录
怎么存款	存款相关问题
我存的钱怎么都没到帐	存款相关问题
久安钱包支付是什么	存款相关问题
存款未到账	存款相关问题
出分游戏	游戏咨询
你告诉我存款成功的截图在那看的。	存款相关问题
忘记账号	账号解锁、忘记账号
无法存款	存款相关问题
是否注册送68	体验金咨询
我要存款	存款相关问题
我的钱怎么没到账	存款相关问题
不能登入	不能登录
久安	存款相关问题
如何存款	存款相关问题
存款未到账	存款相关问题
怎么存款	存款相关问题
我户内转账的钱不见了	转账咨询
微信扫码	存款相关问题
忘记密码	忘记密码
我忘记密码了	忘记密码
你们可以用信用卡吗	存款相关问题
下载EBET手机客户端	app咨询
游戏平台APP/客户端下载	app咨询
我怎么没有领取到返水	返水咨询
账号被冻结了	账号解锁、忘记账号
存款不到帐	存款相关问题
官网网址	不能登录
存款未到账	存款相关问题
13000提款这次要等多久	提款相关问题
我怎么没有领取到返水	返水咨询
索取官网网址	不能登录
提款这次要等多久	提款相关问题
我要找账号	账号解锁、忘记账号
SW出分的游戏	游戏咨询
反水	返水咨询
转账异常，无法使用支付宝转账	存款相关问题
怎么提款还没到呀	提款相关问题
我的账号怎么被锁了	账号解锁、忘记账号
本月优惠	咨询当下相关活动
云闪付存款	存款相关问题
取消微信秒存订单	存款相关问题
尊宝出分吗	游戏咨询
我怎么没有领取到返水	返水咨询
出分推荐	游戏咨询
你好，我今天的有效投注有多少？	游戏咨询
有什么优惠	红包咨询
如何领取体验金	体验金咨询
我的账号怎么被锁了	账号解锁、忘记账号
特邀红包	红包咨询
我为什么不能提款了	提款相关问题
如何领取体验金	体验金咨询
提款被取消	提款相关问题
户内转账转不出来	提款相关问题
我的存款怎么还没有到账	存款相关问题
账号忘记了	账号解锁、忘记账号
云闪付支付成功又没到账	存款相关问题
论坛有什么优惠吗	咨询当下相关活动
体验金	体验金咨询
PT客户端连接	app咨询
草泥马	体验金咨询
我忘记密码了	忘记密码
你们怎么回事？久安冲值时时不到账	存款相关问题
我要电话客服	修改账号资料
告诉我今日的出分游戏	游戏咨询
帮我查查流水	刷新流水
救援金怎么领	救援金咨询
我户内转账的钱不见了	转账咨询
体验金咨询	体验金咨询
网址	不能登录
注册送菜金吗	体验金咨询
怎么那个专属客服不理人。加她微信了	官网及账号问题
自助反水什么时候才有	返水咨询
游戏登入前缀要加什么	游戏咨询
自助反水	返水咨询
我想查询赔付的问题	游戏咨询
帐号以锁请解锁	账号解锁、忘记账号
每日签到的钱怎么转到游戏里	咨询当下相关活动
小宝好贴心提醒：您今天~签到了吗？若还没有，请记得去签到！ 关于签到，您有什么疑问需要小宝解答的吗？	咨询当下相关活动
Pt客户端前面要加什么	游戏咨询
怎么存款	存款相关问题
你好流水怎么打不完呢？	刷新流水
为什么不能提款	提款相关问题
修改账号资料	修改账号资料
我要救援金	救援金咨询
出分	游戏咨询
忘记账号	账号解锁、忘记账号
你们代理的佣金怎么提不出来	官网及账号问题
您可以加我们市场部联络人员QQ927798416 ，微信 YY7880226或者 zb9453， 邮	官网及账号问题
我想查询游戏记录	游戏咨询
开户彩金咋领了？	体验金咨询
云闪付维护好没	存款相关问题
我想查询游戏记录	游戏咨询
无法申请体验金，提示重复讯息或是审核未通过	体验金咨询
什么重复了	体验金咨询
游戏登入前缀要加什么	游戏咨询
申请体验金提示我银行卡重复	体验金咨询
最近怎都不出分	游戏咨询
收不到验证码	体验金咨询
我忘记密马	游戏咨询
刚注册的会员，是不是要送88？	体验金咨询
